ACWI
AAPL	APPLE INC	/etf/ea/ETZCW.djhtm?c=1&etfid=AAPL.US&back=ACWI
MSFT	MICROSOFT CORP	/etf/ea/ETZCW.djhtm?c=1&etfid=MSFT.US&back=ACWI
AMZN	AMAZON COM INC	/etf/ea/ETZCW.djhtm?c=1&etfid=AMZN.US&back=ACWI
TSLA	TESLA INC	/etf/ea/ETZCW.djhtm?c=1&etfid=TSLA.US&back=ACWI
GOOGL	ALPHABET INC CLASS A	/etf/ea/ETZCW.djhtm?c=1&etfid=GOOGL.US&back=ACWI
GOOG	ALPHABET INC CLASS C	/etf/ea/ETZCW.djhtm?c=1&etfid=GOOG.US&back=ACWI
UNH	UNITEDHEALTH GROUP INC	/etf/ea/ETZCW.djhtm?c=1&etfid=UNH.US&back=ACWI
JNJ	JOHNSON & JOHNSON	/etf/ea/ETZCW.djhtm?c=1&etfid=JNJ.US&back=ACWI
2330.TW&back=ACWI	TAIWAN SEMICONDUCTOR MANUFACTURING	/etf/ea/ETZCW.djhtm?c=1&etfid=2330.TW&back=ACWI
XOM	EXXON MOBIL CORP	/etf/ea/ETZCW.djhtm?c=1&etfid=XOM.US&back=ACWI
NVDA	NVIDIA CORP	/etf/ea/ETZCW.djhtm?c=1&etfid=NVDA.US&back=ACWI
META	META PLATFORMS INC CLASS A	/etf/ea/ETZCW.djhtm?c=1&etfid=META.US&back=ACWI
BRK.B	BERKSHIRE HATHAWAY INC CLASS B	/etf/ea/ETZCW.djhtm?c=1&etfid=BRK.B.US&back=ACWI
	NESTLE SA	
PG	PROCTER & GAMBLE	/etf/ea/ETZCW.djhtm?c=1&etfid=PG.US&back=ACWI
V	VISA INC CLASS A	/etf/ea/ETZCW.djhtm?c=1&etfid=V.US&back=ACWI
JPM	JPMORGAN CHASE & CO	/etf/ea/ETZCW.djhtm?c=1&etfid=JPM.US&back=ACWI
HD	HOME DEPOT INC	/etf/ea/ETZCW.djhtm?c=1&etfid=HD.US&back=ACWI
CVX	CHEVRON CORP	/etf/ea/ETZCW.djhtm?c=1&etfid=CVX.US&back=ACWI
MA	MASTERCARD INC CLASS A	/etf/ea/ETZCW.djhtm?c=1&etfid=MA.US&back=ACWI
0700.HK&back=ACWI	TENCENT HOLDINGS LTD	/etf/ea/ETZCW.djhtm?c=1&etfid=0700.HK&back=ACWI
PFE	PFIZER INC	/etf/ea/ETZCW.djhtm?c=1&etfid=PFE.US&back=ACWI
KO	COCA-COLA	/etf/ea/ETZCW.djhtm?c=1&etfid=KO.US&back=ACWI
LLY	ELI LILLY	/etf/ea/ETZCW.djhtm?c=1&etfid=LLY.US&back=ACWI
BAC	BANK OF AMERICA CORP	/etf/ea/ETZCW.djhtm?c=1&etfid=BAC.US&back=ACWI
ABBV	ABBVIE INC	/etf/ea/ETZCW.djhtm?c=1&etfid=ABBV.US&back=ACWI
PEP	PEPSICO INC	/etf/ea/ETZCW.djhtm?c=1&etfid=PEP.US&back=ACWI
COST	COSTCO WHOLESALE CORP	/etf/ea/ETZCW.djhtm?c=1&etfid=COST.US&back=ACWI
	ROCHE HOLDING PAR AG	
MRK	MERCK & CO INC	/etf/ea/ETZCW.djhtm?c=1&etfid=MRK.US&back=ACWI
TMO	THERMO FISHER SCIENTIFIC INC	/etf/ea/ETZCW.djhtm?c=1&etfid=TMO.US&back=ACWI
005930.KS&back=ACWI	SAMSUNG ELECTRONICS LTD	/etf/ea/ETZCW.djhtm?c=1&etfid=005930.KS&back=ACWI
DIS	WALT DISNEY	/etf/ea/ETZCW.djhtm?c=1&etfid=DIS.US&back=ACWI
	SHELL PLC	
AVGO	BROADCOM INC	/etf/ea/ETZCW.djhtm?c=1&etfid=AVGO.US&back=ACWI
	ASML HOLDING NV	
WMT	WALMART INC	/etf/ea/ETZCW.djhtm?c=1&etfid=WMT.US&back=ACWI
	ASTRAZENECA PLC	
CSCO	CISCO SYSTEMS INC	/etf/ea/ETZCW.djhtm?c=1&etfid=CSCO.US&back=ACWI
MCD	MCDONALDS CORP	/etf/ea/ETZCW.djhtm?c=1&etfid=MCD.US&back=ACWI
9988.HK&back=ACWI	ALIBABA GROUP HOLDING LTD	/etf/ea/ETZCW.djhtm?c=1&etfid=9988.HK&back=ACWI
ACN	ACCENTURE PLC CLASS A	/etf/ea/ETZCW.djhtm?c=1&etfid=ACN.US&back=ACWI
ABT	ABBOTT LABORATORIES	/etf/ea/ETZCW.djhtm?c=1&etfid=ABT.US&back=ACWI
DHR	DANAHER CORP	/etf/ea/ETZCW.djhtm?c=1&etfid=DHR.US&back=ACWI
	LVMH	
	NOVO NORDISKCLASS B	
	NOVARTIS AG	
ADBE	ADOBE INC	/etf/ea/ETZCW.djhtm?c=1&etfid=ADBE.US&back=ACWI
VZ	VERIZON COMMUNICATIONS INC	/etf/ea/ETZCW.djhtm?c=1&etfid=VZ.US&back=ACWI
WFC	WELLS FARGO	/etf/ea/ETZCW.djhtm?c=1&etfid=WFC.US&back=ACWI
NEE	NEXTERA ENERGY INC	/etf/ea/ETZCW.djhtm?c=1&etfid=NEE.US&back=ACWI
CMCSA	COMCAST CORP CLASS A	/etf/ea/ETZCW.djhtm?c=1&etfid=CMCSA.US&back=ACWI
7203.JP&back=ACWI	TOYOTA MOTOR CORP	/etf/ea/ETZCW.djhtm?c=1&etfid=7203.JP&back=ACWI
CRM	SALESFORCE INC	/etf/ea/ETZCW.djhtm?c=1&etfid=CRM.US&back=ACWI
TXN	TEXAS INSTRUMENT INC	/etf/ea/ETZCW.djhtm?c=1&etfid=TXN.US&back=ACWI
QCOM	QUALCOMM INC	/etf/ea/ETZCW.djhtm?c=1&etfid=QCOM.US&back=ACWI
LIN	LINDE PLC	/etf/ea/ETZCW.djhtm?c=1&etfid=LIN.US&back=ACWI
PM	PHILIP MORRIS INTERNATIONAL INC	/etf/ea/ETZCW.djhtm?c=1&etfid=PM.US&back=ACWI
BMY	BRISTOL MYERS SQUIBB	/etf/ea/ETZCW.djhtm?c=1&etfid=BMY.US&back=ACWI
UNP	UNION PACIFIC CORP	/etf/ea/ETZCW.djhtm?c=1&etfid=UNP.US&back=ACWI
UPS	UNITED PARCEL SERVICE INC CLASS B	/etf/ea/ETZCW.djhtm?c=1&etfid=UPS.US&back=ACWI
COP	CONOCOPHILLIPS	/etf/ea/ETZCW.djhtm?c=1&etfid=COP.US&back=ACWI
	BHP GROUP LTD	
AMD	ADVANCED MICRO DEVICES INC	/etf/ea/ETZCW.djhtm?c=1&etfid=AMD.US&back=ACWI
NKE	NIKE INC CLASS B	/etf/ea/ETZCW.djhtm?c=1&etfid=NKE.US&back=ACWI
RTX	RAYTHEON TECHNOLOGIES CORP	/etf/ea/ETZCW.djhtm?c=1&etfid=RTX.US&back=ACWI
AMGN	AMGEN INC	/etf/ea/ETZCW.djhtm?c=1&etfid=AMGN.US&back=ACWI
	ROYAL BANK OF CANADA	
HON	HONEYWELL INTERNATIONAL INC	/etf/ea/ETZCW.djhtm?c=1&etfid=HON.US&back=ACWI
CVS	CVS HEALTH CORP	/etf/ea/ETZCW.djhtm?c=1&etfid=CVS.US&back=ACWI
	TOTALENERGIES	
INTC	INTEL CORPORATION CORP	/etf/ea/ETZCW.djhtm?c=1&etfid=INTC.US&back=ACWI
LOW	LOWES COMPANIES INC	/etf/ea/ETZCW.djhtm?c=1&etfid=LOW.US&back=ACWI
	HSBC HOLDINGS PLC	
SPGI	S&P GLOBAL INC	/etf/ea/ETZCW.djhtm?c=1&etfid=SPGI.US&back=ACWI
T	AT&T INC	/etf/ea/ETZCW.djhtm?c=1&etfid=T.US&back=ACWI
ORCL	ORACLE CORP	/etf/ea/ETZCW.djhtm?c=1&etfid=ORCL.US&back=ACWI
1299.HK&back=ACWI	AIA GROUP LTD	/etf/ea/ETZCW.djhtm?c=1&etfid=1299.HK&back=ACWI
ELV	ELEVANCE HEALTH INC	/etf/ea/ETZCW.djhtm?c=1&etfid=ELV.US&back=ACWI
INTU	INTUIT INC	/etf/ea/ETZCW.djhtm?c=1&etfid=INTU.US&back=ACWI
MDT	MEDTRONIC PLC	/etf/ea/ETZCW.djhtm?c=1&etfid=MDT.US&back=ACWI
	UNILEVER PLC	
	TORONTO DOMINION	
AMT	AMERICAN TOWER REIT CORP	/etf/ea/ETZCW.djhtm?c=1&etfid=AMT.US&back=ACWI
IBM	INTERNATIONAL BUSINESS MACHINES CO	/etf/ea/ETZCW.djhtm?c=1&etfid=IBM.US&back=ACWI
MS	MORGAN STANLEY	/etf/ea/ETZCW.djhtm?c=1&etfid=MS.US&back=ACWI
	COMMONWEALTH BANK OF AUSTRALIA	
GS	GOLDMAN SACHS GROUP INC	/etf/ea/ETZCW.djhtm?c=1&etfid=GS.US&back=ACWI
3690.HK&back=ACWI	MEITUAN	/etf/ea/ETZCW.djhtm?c=1&etfid=3690.HK&back=ACWI
ADP	AUTOMATIC DATA PROCESSING INC	/etf/ea/ETZCW.djhtm?c=1&etfid=ADP.US&back=ACWI
DE	DEERE	/etf/ea/ETZCW.djhtm?c=1&etfid=DE.US&back=ACWI
BLK	BLACKROCK INC	/etf/ea/ETZCW.djhtm?c=1&etfid=BLK.US&back=ACWI
PYPL	PAYPAL HOLDINGS INC	/etf/ea/ETZCW.djhtm?c=1&etfid=PYPL.US&back=ACWI
	BP PLC	
SCHW	CHARLES SCHWAB CORP	/etf/ea/ETZCW.djhtm?c=1&etfid=SCHW.US&back=ACWI
LMT	LOCKHEED MARTIN CORP	/etf/ea/ETZCW.djhtm?c=1&etfid=LMT.US&back=ACWI
6758.JP&back=ACWI	SONY GROUP CORP	/etf/ea/ETZCW.djhtm?c=1&etfid=6758.JP&back=ACWI
CAT	CATERPILLAR INC	/etf/ea/ETZCW.djhtm?c=1&etfid=CAT.US&back=ACWI
	RELIANCE INDUSTRIES LTD	
	DIAGEO PLC	
NFLX	NETFLIX INC	/etf/ea/ETZCW.djhtm?c=1&etfid=NFLX.US&back=ACWI
AXP	AMERICAN EXPRESS	/etf/ea/ETZCW.djhtm?c=1&etfid=AXP.US&back=ACWI
SBUX	STARBUCKS CORP	/etf/ea/ETZCW.djhtm?c=1&etfid=SBUX.US&back=ACWI
	CSL LTD	
	SANOFI SA	
PLD	PROLOGIS REIT INC	/etf/ea/ETZCW.djhtm?c=1&etfid=PLD.US&back=ACWI
CI	CIGNA CORP	/etf/ea/ETZCW.djhtm?c=1&etfid=CI.US&back=ACWI
C	CITIGROUP INC	/etf/ea/ETZCW.djhtm?c=1&etfid=C.US&back=ACWI
	BLK CSH FND TREASURY SL AGENCY	
	SAP	
BA	BOEING	/etf/ea/ETZCW.djhtm?c=1&etfid=BA.US&back=ACWI
TMUS	T MOBILE US INC	/etf/ea/ETZCW.djhtm?c=1&etfid=TMUS.US&back=ACWI
NOW	SERVICENOW INC	/etf/ea/ETZCW.djhtm?c=1&etfid=NOW.US&back=ACWI
MDLZ	MONDELEZ INTERNATIONAL INC CLASS A	/etf/ea/ETZCW.djhtm?c=1&etfid=MDLZ.US&back=ACWI
	BRITISH AMERICAN TOBACCO PLC	
	LOREAL SA	
	ENBRIDGE INC	
AMAT	APPLIED MATERIAL INC	/etf/ea/ETZCW.djhtm?c=1&etfid=AMAT.US&back=ACWI
SO	SOUTHERN	/etf/ea/ETZCW.djhtm?c=1&etfid=SO.US&back=ACWI
MMC	MARSH & MCLENNAN INC	/etf/ea/ETZCW.djhtm?c=1&etfid=MMC.US&back=ACWI
MO	ALTRIA GROUP INC	/etf/ea/ETZCW.djhtm?c=1&etfid=MO.US&back=ACWI
CB	CHUBB LTD	/etf/ea/ETZCW.djhtm?c=1&etfid=CB.US&back=ACWI
DUK	DUKE ENERGY CORP	/etf/ea/ETZCW.djhtm?c=1&etfid=DUK.US&back=ACWI
ADI	ANALOG DEVICES INC	/etf/ea/ETZCW.djhtm?c=1&etfid=ADI.US&back=ACWI
GE	GENERAL ELECTRIC	/etf/ea/ETZCW.djhtm?c=1&etfid=GE.US&back=ACWI
GILD	GILEAD SCIENCES INC	/etf/ea/ETZCW.djhtm?c=1&etfid=GILD.US&back=ACWI
	SIEMENS N AG	
BKNG	BOOKING HOLDINGS INC	/etf/ea/ETZCW.djhtm?c=1&etfid=BKNG.US&back=ACWI
TGT	TARGET CORP	/etf/ea/ETZCW.djhtm?c=1&etfid=TGT.US&back=ACWI
ZTS	ZOETIS INC CLASS A	/etf/ea/ETZCW.djhtm?c=1&etfid=ZTS.US&back=ACWI
CCI	CROWN CASTLE INC	/etf/ea/ETZCW.djhtm?c=1&etfid=CCI.US&back=ACWI
ISRG	INTUITIVE SURGICAL INC	/etf/ea/ETZCW.djhtm?c=1&etfid=ISRG.US&back=ACWI
TJX	TJX INC	/etf/ea/ETZCW.djhtm?c=1&etfid=TJX.US&back=ACWI
6861.JP&back=ACWI	KEYENCE CORP	/etf/ea/ETZCW.djhtm?c=1&etfid=6861.JP&back=ACWI
BDX	BECTON DICKINSON	/etf/ea/ETZCW.djhtm?c=1&etfid=BDX.US&back=ACWI
PGR	PROGRESSIVE CORP	/etf/ea/ETZCW.djhtm?c=1&etfid=PGR.US&back=ACWI
VRTX	VERTEX PHARMACEUTICALS INC	/etf/ea/ETZCW.djhtm?c=1&etfid=VRTX.US&back=ACWI
NOC	NORTHROP GRUMMAN CORP	/etf/ea/ETZCW.djhtm?c=1&etfid=NOC.US&back=ACWI
WM	WASTE MANAGEMENT INC	/etf/ea/ETZCW.djhtm?c=1&etfid=WM.US&back=ACWI
CME	CME GROUP INC CLASS A	/etf/ea/ETZCW.djhtm?c=1&etfid=CME.US&back=ACWI
	CANADIAN PACIFIC RAILWAY LTD	
SYK	STRYKER CORP	/etf/ea/ETZCW.djhtm?c=1&etfid=SYK.US&back=ACWI
MMM	3M	/etf/ea/ETZCW.djhtm?c=1&etfid=MMM.US&back=ACWI
	CANADIAN NATIONAL RAILWAY	
CSX	CSX CORP	/etf/ea/ETZCW.djhtm?c=1&etfid=CSX.US&back=ACWI
	BROOKFIELD ASSET MANAGEMENT INC CL	
PNC	PNC FINANCIAL SERVICES GROUP INC	/etf/ea/ETZCW.djhtm?c=1&etfid=PNC.US&back=ACWI
	ZURICH INSURANCE GROUP AG	
	SCHNEIDER ELECTRIC	
	LAIR LIQUIDE SOCIETE ANONYME POUR	
	RIO TINTO PLC	
	ALLIANZ	
OXY	OCCIDENTAL PETROLEUM CORP	/etf/ea/ETZCW.djhtm?c=1&etfid=OXY.US&back=ACWI
	CANADIAN NATURAL RESOURCES LTD	
9618.HK&back=ACWI	JD.COM CLASS A INC	/etf/ea/ETZCW.djhtm?c=1&etfid=9618.HK&back=ACWI
	NATIONAL AUSTRALIA BANK LTD	
EOG	EOG RESOURCES INC	/etf/ea/ETZCW.djhtm?c=1&etfid=EOG.US&back=ACWI
	BANK OF NOVA SCOTIA	
8306.JP&back=ACWI	MITSUBISHI UFJ FINANCIAL GROUP INC	/etf/ea/ETZCW.djhtm?c=1&etfid=8306.JP&back=ACWI
	INFOSYS LTD	
BX	BLACKSTONE INC	/etf/ea/ETZCW.djhtm?c=1&etfid=BX.US&back=ACWI
D	DOMINION ENERGY INC	/etf/ea/ETZCW.djhtm?c=1&etfid=D.US&back=ACWI
TFC	TRUIST FINANCIAL CORP	/etf/ea/ETZCW.djhtm?c=1&etfid=TFC.US&back=ACWI
	IBERDROLA SA	
MU	MICRON TECHNOLOGY INC	/etf/ea/ETZCW.djhtm?c=1&etfid=MU.US&back=ACWI
REGN	REGENERON PHARMACEUTICALS INC	/etf/ea/ETZCW.djhtm?c=1&etfid=REGN.US&back=ACWI
	GLAXOSMITHKLINE	
	DEUTSCHE TELEKOM N AG	
ITW	ILLINOIS TOOL INC	/etf/ea/ETZCW.djhtm?c=1&etfid=ITW.US&back=ACWI
LRCX	LAM RESEARCH CORP	/etf/ea/ETZCW.djhtm?c=1&etfid=LRCX.US&back=ACWI
HUM	HUMANA INC	/etf/ea/ETZCW.djhtm?c=1&etfid=HUM.US&back=ACWI
	BANK OF MONTREAL	
USB	US BANCORP	/etf/ea/ETZCW.djhtm?c=1&etfid=USB.US&back=ACWI
AON	AON PLC CLASS A	/etf/ea/ETZCW.djhtm?c=1&etfid=AON.US&back=ACWI
ATVI	ACTIVISION BLIZZARD INC	/etf/ea/ETZCW.djhtm?c=1&etfid=ATVI.US&back=ACWI
FISV	FISERV INC	/etf/ea/ETZCW.djhtm?c=1&etfid=FISV.US&back=ACWI
F	FORD MOTOR CO	/etf/ea/ETZCW.djhtm?c=1&etfid=F.US&back=ACWI
EL	ESTEE LAUDER INC CLASS A	/etf/ea/ETZCW.djhtm?c=1&etfid=EL.US&back=ACWI
	COMPAGNIE FINANCIERE RICHEMONT SA	
0939.HK&back=ACWI	CHINA CONSTRUCTION BANK CORP H	/etf/ea/ETZCW.djhtm?c=1&etfid=0939.HK&back=ACWI
EQIX	EQUINIX REIT INC	/etf/ea/ETZCW.djhtm?c=1&etfid=EQIX.US&back=ACWI
BSX	BOSTON SCIENTIFIC CORP	/etf/ea/ETZCW.djhtm?c=1&etfid=BSX.US&back=ACWI
CL	COLGATE-PALMOLIVE	/etf/ea/ETZCW.djhtm?c=1&etfid=CL.US&back=ACWI
	AIRBUS GROUP	
NSC	NORFOLK SOUTHERN CORP	/etf/ea/ETZCW.djhtm?c=1&etfid=NSC.US&back=ACWI
ICE	INTERCONTINENTAL EXCHANGE INC	/etf/ea/ETZCW.djhtm?c=1&etfid=ICE.US&back=ACWI
SHW	SHERWIN WILLIAMS	/etf/ea/ETZCW.djhtm?c=1&etfid=SHW.US&back=ACWI
	UBS GROUP AG	
EW	EDWARDS LIFESCIENCES CORP	/etf/ea/ETZCW.djhtm?c=1&etfid=EW.US&back=ACWI
MPC	MARATHON PETROLEUM CORP	/etf/ea/ETZCW.djhtm?c=1&etfid=MPC.US&back=ACWI
PXD	PIONEER NATURAL RESOURCE	/etf/ea/ETZCW.djhtm?c=1&etfid=PXD.US&back=ACWI
PANW	PALO ALTO NETWORKS INC	/etf/ea/ETZCW.djhtm?c=1&etfid=PANW.US&back=ACWI
APD	AIR PRODUCTS AND CHEMICALS INC	/etf/ea/ETZCW.djhtm?c=1&etfid=APD.US&back=ACWI
	GLENCORE PLC	
	HOUSING DEVELOPMENT FINANCE CORPOR	
DG	DOLLAR GENERAL CORP	/etf/ea/ETZCW.djhtm?c=1&etfid=DG.US&back=ACWI
	ICICI BANK LTD	
MCK	MCKESSON CORP	/etf/ea/ETZCW.djhtm?c=1&etfid=MCK.US&back=ACWI
FIS	FIDELITY NATIONAL INFORMATION SERV	/etf/ea/ETZCW.djhtm?c=1&etfid=FIS.US&back=ACWI
	RECKITT BENCKISER GROUP PLC	
PSA	PUBLIC STORAGE REIT	/etf/ea/ETZCW.djhtm?c=1&etfid=PSA.US&back=ACWI
KLAC	KLA CORP	/etf/ea/ETZCW.djhtm?c=1&etfid=KLAC.US&back=ACWI
ETN	EATON PLC	/etf/ea/ETZCW.djhtm?c=1&etfid=ETN.US&back=ACWI
4568.JP&back=ACWI	DAIICHI SANKYO LTD	/etf/ea/ETZCW.djhtm?c=1&etfid=4568.JP&back=ACWI
CNC	CENTENE CORP	/etf/ea/ETZCW.djhtm?c=1&etfid=CNC.US&back=ACWI
SLB	SCHLUMBERGER NV	/etf/ea/ETZCW.djhtm?c=1&etfid=SLB.US&back=ACWI
	BAYER AG	
	RELX PLC	
	PROSUS NV	
FDX	FEDEX CORP	/etf/ea/ETZCW.djhtm?c=1&etfid=FDX.US&back=ACWI
	NUTRIEN LTD	
	BNP PARIBAS SA	
	WESTPAC BANKING CORPORATION CORP	
SNPS	SYNOPSYS INC	/etf/ea/ETZCW.djhtm?c=1&etfid=SNPS.US&back=ACWI
9433.JP&back=ACWI	KDDI CORP	/etf/ea/ETZCW.djhtm?c=1&etfid=9433.JP&back=ACWI
EMR	EMERSON ELECTRIC	/etf/ea/ETZCW.djhtm?c=1&etfid=EMR.US&back=ACWI
AEP	AMERICAN ELECTRIC POWER INC	/etf/ea/ETZCW.djhtm?c=1&etfid=AEP.US&back=ACWI
CDNS	CADENCE DESIGN SYSTEMS INC	/etf/ea/ETZCW.djhtm?c=1&etfid=CDNS.US&back=ACWI
GD	GENERAL DYNAMICS CORP	/etf/ea/ETZCW.djhtm?c=1&etfid=GD.US&back=ACWI
GM	GENERAL MOTORS	/etf/ea/ETZCW.djhtm?c=1&etfid=GM.US&back=ACWI
ADM	ARCHER DANIELS MIDLAND	/etf/ea/ETZCW.djhtm?c=1&etfid=ADM.US&back=ACWI
CHTR	CHARTER COMMUNICATIONS INC CLASS A	/etf/ea/ETZCW.djhtm?c=1&etfid=CHTR.US&back=ACWI
	CIA VALE DO RIO DOCESH	
	VINCI SA	
MCO	MOODYS CORP	/etf/ea/ETZCW.djhtm?c=1&etfid=MCO.US&back=ACWI
ORLY	OREILLY AUTOMOTIVE INC	/etf/ea/ETZCW.djhtm?c=1&etfid=ORLY.US&back=ACWI
SRE	SEMPRA	/etf/ea/ETZCW.djhtm?c=1&etfid=SRE.US&back=ACWI
	ABB LTD	
	SUNCOR ENERGY INC	
HCA	HCA HEALTHCARE INC	/etf/ea/ETZCW.djhtm?c=1&etfid=HCA.US&back=ACWI
0388.HK&back=ACWI	HONG KONG EXCHANGES AND CLEARING L	/etf/ea/ETZCW.djhtm?c=1&etfid=0388.HK&back=ACWI
MET	METLIFE INC	/etf/ea/ETZCW.djhtm?c=1&etfid=MET.US&back=ACWI
9984.JP&back=ACWI	SOFTBANK GROUP CORP	/etf/ea/ETZCW.djhtm?c=1&etfid=9984.JP&back=ACWI
VLO	VALERO ENERGY CORP	/etf/ea/ETZCW.djhtm?c=1&etfid=VLO.US&back=ACWI
6501.JP&back=ACWI	HITACHI LTD	/etf/ea/ETZCW.djhtm?c=1&etfid=6501.JP&back=ACWI
7974.JP&back=ACWI	NINTENDO LTD	/etf/ea/ETZCW.djhtm?c=1&etfid=7974.JP&back=ACWI
6098.JP&back=ACWI	RECRUIT HOLDINGS LTD	/etf/ea/ETZCW.djhtm?c=1&etfid=6098.JP&back=ACWI
8035.JP&back=ACWI	TOKYO ELECTRON LTD	/etf/ea/ETZCW.djhtm?c=1&etfid=8035.JP&back=ACWI
	TC ENERGY CORP	
CTVA	CORTEVA INC	/etf/ea/ETZCW.djhtm?c=1&etfid=CTVA.US&back=ACWI
APH	AMPHENOL CORP CLASS A	/etf/ea/ETZCW.djhtm?c=1&etfid=APH.US&back=ACWI
	MERCEDES-BENZ GROUP N AG	
	AUSTRALIA AND NEW ZEALAND BANKING	
ADSK	AUTODESK INC	/etf/ea/ETZCW.djhtm?c=1&etfid=ADSK.US&back=ACWI
DVN	DEVON ENERGY CORP	/etf/ea/ETZCW.djhtm?c=1&etfid=DVN.US&back=ACWI
	THE SAUDI NATIONAL BANK	
	AL RAJHI BANK	
CMG	CHIPOTLE MEXICAN GRILL INC	/etf/ea/ETZCW.djhtm?c=1&etfid=CMG.US&back=ACWI
4063.JP&back=ACWI	SHIN ETSU CHEMICAL LTD	/etf/ea/ETZCW.djhtm?c=1&etfid=4063.JP&back=ACWI
NXPI	NXP SEMICONDUCTORS NV	/etf/ea/ETZCW.djhtm?c=1&etfid=NXPI.US&back=ACWI
MRNA	MODERNA INC	/etf/ea/ETZCW.djhtm?c=1&etfid=MRNA.US&back=ACWI
	ESSILORLUXOTTICA SA	
FCX	FREEPORT MCMORAN INC	/etf/ea/ETZCW.djhtm?c=1&etfid=FCX.US&back=ACWI
EXC	EXELON CORP	/etf/ea/ETZCW.djhtm?c=1&etfid=EXC.US&back=ACWI
GIS	GENERAL MILLS INC	/etf/ea/ETZCW.djhtm?c=1&etfid=GIS.US&back=ACWI
MAR	MARRIOTT INTERNATIONAL INC CLASS A	/etf/ea/ETZCW.djhtm?c=1&etfid=MAR.US&back=ACWI
LHX	L3HARRIS TECHNOLOGIES INC	/etf/ea/ETZCW.djhtm?c=1&etfid=LHX.US&back=ACWI
	CANADIAN IMPERIAL BANK OF COMMERCE	
AIG	AMERICAN INTERNATIONAL GROUP INC	/etf/ea/ETZCW.djhtm?c=1&etfid=AIG.US&back=ACWI
	WOODSIDE ENERGY GROUP LTD	
2317.TW&back=ACWI	HON HAI PRECISION INDUSTRY LTD	/etf/ea/ETZCW.djhtm?c=1&etfid=2317.TW&back=ACWI
AZO	AUTOZONE INC	/etf/ea/ETZCW.djhtm?c=1&etfid=AZO.US&back=ACWI
4502.JP&back=ACWI	TAKEDA PHARMACEUTICAL LTD	/etf/ea/ETZCW.djhtm?c=1&etfid=4502.JP&back=ACWI
ROP	ROPER TECHNOLOGIES INC	/etf/ea/ETZCW.djhtm?c=1&etfid=ROP.US&back=ACWI
	AXA SA	
ECL	ECOLAB INC	/etf/ea/ETZCW.djhtm?c=1&etfid=ECL.US&back=ACWI
6367.JP&back=ACWI	DAIKIN INDUSTRIES LTD	/etf/ea/ETZCW.djhtm?c=1&etfid=6367.JP&back=ACWI
PSX	PHILLIPS 66	/etf/ea/ETZCW.djhtm?c=1&etfid=PSX.US&back=ACWI
UBER	UBER TECHNOLOGIES INC	/etf/ea/ETZCW.djhtm?c=1&etfid=UBER.US&back=ACWI
	LONZA GROUP AG	
PAYX	PAYCHEX INC	/etf/ea/ETZCW.djhtm?c=1&etfid=PAYX.US&back=ACWI
	MACQUARIE GROUP LTD DEF	
COF	CAPITAL ONE FINANCIAL CORP	/etf/ea/ETZCW.djhtm?c=1&etfid=COF.US&back=ACWI
SYY	SYSCO CORP	/etf/ea/ETZCW.djhtm?c=1&etfid=SYY.US&back=ACWI
TEL	TE CONNECTIVITY LTD	/etf/ea/ETZCW.djhtm?c=1&etfid=TEL.US&back=ACWI
MSI	MOTOROLA SOLUTIONS INC	/etf/ea/ETZCW.djhtm?c=1&etfid=MSI.US&back=ACWI
7267.JP&back=ACWI	HONDA MOTOR LTD	/etf/ea/ETZCW.djhtm?c=1&etfid=7267.JP&back=ACWI
	HERMES INTERNATIONAL	
	NATIONAL GRID PLC	
STZ	CONSTELLATION BRANDS INC CLASS A	/etf/ea/ETZCW.djhtm?c=1&etfid=STZ.US&back=ACWI
	PERNOD RICARD SA	
ABNB	AIRBNB INC CLASS A	/etf/ea/ETZCW.djhtm?c=1&etfid=ABNB.US&back=ACWI
KMB	KIMBERLY CLARK CORP	/etf/ea/ETZCW.djhtm?c=1&etfid=KMB.US&back=ACWI
8058.JP&back=ACWI	MITSUBISHI CORP	/etf/ea/ETZCW.djhtm?c=1&etfid=8058.JP&back=ACWI
XEL	XCEL ENERGY INC	/etf/ea/ETZCW.djhtm?c=1&etfid=XEL.US&back=ACWI
	EQUINOR	
	BANCO SANTANDER SA	
SNOW	SNOWFLAKE CLASS A	/etf/ea/ETZCW.djhtm?c=1&etfid=SNOW.US&back=ACWI
000660.KS&back=ACWI	SK HYNIX INC	/etf/ea/ETZCW.djhtm?c=1&etfid=000660.KS&back=ACWI
TRV	TRAVELERS COMPANIES INC	/etf/ea/ETZCW.djhtm?c=1&etfid=TRV.US&back=ACWI
9888.HK&back=ACWI	BAIDU CLASS A INC	/etf/ea/ETZCW.djhtm?c=1&etfid=9888.HK&back=ACWI
AFL	AFLAC INC	/etf/ea/ETZCW.djhtm?c=1&etfid=AFL.US&back=ACWI
LNG	CHENIERE ENERGY INC	/etf/ea/ETZCW.djhtm?c=1&etfid=LNG.US&back=ACWI
	TATA CONSULTANCY SERVICES LTD	
MRVL	MARVELL TECHNOLOGY INC	/etf/ea/ETZCW.djhtm?c=1&etfid=MRVL.US&back=ACWI
	BASF N	
JCI	JOHNSON CONTROLS INTERNATIONAL PLC	/etf/ea/ETZCW.djhtm?c=1&etfid=JCI.US&back=ACWI
	KERING SA	
A	AGILENT TECHNOLOGIES INC	/etf/ea/ETZCW.djhtm?c=1&etfid=A.US&back=ACWI
DOW	DOW INC	/etf/ea/ETZCW.djhtm?c=1&etfid=DOW.US&back=ACWI
	PETROLEO BRASILEIRO PREF SA	
ENPH	ENPHASE ENERGY INC	/etf/ea/ETZCW.djhtm?c=1&etfid=ENPH.US&back=ACWI
MELI	MERCADOLIBRE INC	/etf/ea/ETZCW.djhtm?c=1&etfid=MELI.US&back=ACWI
TT	TRANE TECHNOLOGIES PLC	/etf/ea/ETZCW.djhtm?c=1&etfid=TT.US&back=ACWI
	ALIMENTATION COUCHE TARD MULTI VOT	
7741.JP&back=ACWI	HOYA CORP	/etf/ea/ETZCW.djhtm?c=1&etfid=7741.JP&back=ACWI
	DBS GROUP HOLDINGS LTD	
KMI	KINDER MORGAN INC	/etf/ea/ETZCW.djhtm?c=1&etfid=KMI.US&back=ACWI
PRU	PRUDENTIAL FINANCIAL INC	/etf/ea/ETZCW.djhtm?c=1&etfid=PRU.US&back=ACWI
	ENEL	
SBAC	SBA COMMUNICATIONS REIT CORP CLASS	/etf/ea/ETZCW.djhtm?c=1&etfid=SBAC.US&back=ACWI
8316.JP&back=ACWI	SUMITOMO MITSUI FINANCIAL GROUP IN	/etf/ea/ETZCW.djhtm?c=1&etfid=8316.JP&back=ACWI
O	REALTY INCOME REIT CORP	/etf/ea/ETZCW.djhtm?c=1&etfid=O.US&back=ACWI
WCN	WASTE CONNECTIONS INC	/etf/ea/ETZCW.djhtm?c=1&etfid=WCN.US&back=ACWI
9999.HK&back=ACWI	NETEASE INC	/etf/ea/ETZCW.djhtm?c=1&etfid=9999.HK&back=ACWI
CRWD	CROWDSTRIKE HOLDINGS INC CLASS A	/etf/ea/ETZCW.djhtm?c=1&etfid=CRWD.US&back=ACWI
WMB	WILLIAMS INC	/etf/ea/ETZCW.djhtm?c=1&etfid=WMB.US&back=ACWI
	DEUTSCHE POST AG	
GPN	GLOBAL PAYMENTS INC	/etf/ea/ETZCW.djhtm?c=1&etfid=GPN.US&back=ACWI
PH	PARKER-HANNIFIN CORP	/etf/ea/ETZCW.djhtm?c=1&etfid=PH.US&back=ACWI
EA	ELECTRONIC ARTS INC	/etf/ea/ETZCW.djhtm?c=1&etfid=EA.US&back=ACWI
IQV	IQVIA HOLDINGS INC	/etf/ea/ETZCW.djhtm?c=1&etfid=IQV.US&back=ACWI
NUE	NUCOR CORP	/etf/ea/ETZCW.djhtm?c=1&etfid=NUE.US&back=ACWI
	SHOPIFY SUBORDINATE VOTING INC CLA	
	ANGLO AMERICAN PLC	
MNST	MONSTER BEVERAGE CORP	/etf/ea/ETZCW.djhtm?c=1&etfid=MNST.US&back=ACWI
LULU	LULULEMON ATHLETICA INC	/etf/ea/ETZCW.djhtm?c=1&etfid=LULU.US&back=ACWI
	ANHEUSER-BUSCH INBEV SA	
	VODAFONE GROUP PLC	
PDD	PINDUODUO ADR REPRESENTINGINC	/etf/ea/ETZCW.djhtm?c=1&etfid=PDD.US&back=ACWI
	COMPASS GROUP PLC	
	WESFARMERS LTD	
DLR	DIGITAL REALTY TRUST REIT INC	/etf/ea/ETZCW.djhtm?c=1&etfid=DLR.US&back=ACWI
	LLOYDS BANKING GROUP PLC	
HES	HESS CORP	/etf/ea/ETZCW.djhtm?c=1&etfid=HES.US&back=ACWI
005935.KS&back=ACWI	SAMSUNG ELECTRONICS NON VOTING PRE	/etf/ea/ETZCW.djhtm?c=1&etfid=005935.KS&back=ACWI
MCHP	MICROCHIP TECHNOLOGY INC	/etf/ea/ETZCW.djhtm?c=1&etfid=MCHP.US&back=ACWI
SQ	BLOCK INC CLASS A	/etf/ea/ETZCW.djhtm?c=1&etfid=SQ.US&back=ACWI
8766.JP&back=ACWI	TOKIO MARINE HOLDINGS INC	/etf/ea/ETZCW.djhtm?c=1&etfid=8766.JP&back=ACWI
	SAFRAN SA	
MSCI	MSCI INC	/etf/ea/ETZCW.djhtm?c=1&etfid=MSCI.US&back=ACWI
8031.JP&back=ACWI	MITSUI LTD	/etf/ea/ETZCW.djhtm?c=1&etfid=8031.JP&back=ACWI
FTNT	FORTINET INC	/etf/ea/ETZCW.djhtm?c=1&etfid=FTNT.US&back=ACWI
CTSH	COGNIZANT TECHNOLOGY SOLUTIONS COR	/etf/ea/ETZCW.djhtm?c=1&etfid=CTSH.US&back=ACWI
	MANULIFE FINANCIAL CORP	
WEC	WEC ENERGY GROUP INC	/etf/ea/ETZCW.djhtm?c=1&etfid=WEC.US&back=ACWI
CARR	CARRIER GLOBAL CORP	/etf/ea/ETZCW.djhtm?c=1&etfid=CARR.US&back=ACWI
	ALCON AG	
PEG	PUBLIC SERVICE ENTERPRISE GROUP IN	/etf/ea/ETZCW.djhtm?c=1&etfid=PEG.US&back=ACWI
ALL	ALLSTATE CORP	/etf/ea/ETZCW.djhtm?c=1&etfid=ALL.US&back=ACWI
	ING GROEP NV	
	CONSTELLATION SOFTWARE INC	
	INVESTOR CLASS B	
KR	KROGER	/etf/ea/ETZCW.djhtm?c=1&etfid=KR.US&back=ACWI
	INFINEON TECHNOLOGIES AG	
RMD	RESMED INC	/etf/ea/ETZCW.djhtm?c=1&etfid=RMD.US&back=ACWI
	MUENCHENER RUECKVERSICHERUNGS-GESE	
YUM	YUM BRANDS INC	/etf/ea/ETZCW.djhtm?c=1&etfid=YUM.US&back=ACWI
CTAS	CINTAS CORP	/etf/ea/ETZCW.djhtm?c=1&etfid=CTAS.US&back=ACWI
	SIKA AG	
NEM	NEWMONT	/etf/ea/ETZCW.djhtm?c=1&etfid=NEM.US&back=ACWI
	DEUTSCHE BOERSE AG	
SPG	SIMON PROPERTY GROUP REIT INC	/etf/ea/ETZCW.djhtm?c=1&etfid=SPG.US&back=ACWI
HSY	HERSHEY FOODS	/etf/ea/ETZCW.djhtm?c=1&etfid=HSY.US&back=ACWI
9432.JP&back=ACWI	NIPPON TELEGRAPH AND TELEPHONE COR	/etf/ea/ETZCW.djhtm?c=1&etfid=9432.JP&back=ACWI
WELL	WELLTOWER	/etf/ea/ETZCW.djhtm?c=1&etfid=WELL.US&back=ACWI
BK	BANK OF NEW YORK MELLON CORP	/etf/ea/ETZCW.djhtm?c=1&etfid=BK.US&back=ACWI
	DANONE SA	
ED	CONSOLIDATED EDISON INC	/etf/ea/ETZCW.djhtm?c=1&etfid=ED.US&back=ACWI
	GBP CASH	
9983.JP&back=ACWI	FAST RETAILING LTD	/etf/ea/ETZCW.djhtm?c=1&etfid=9983.JP&back=ACWI
2454.TW&back=ACWI	MEDIATEK INC	/etf/ea/ETZCW.djhtm?c=1&etfid=2454.TW&back=ACWI
ALB	ALBEMARLE CORP	/etf/ea/ETZCW.djhtm?c=1&etfid=ALB.US&back=ACWI
DXCM	DEXCOM INC	/etf/ea/ETZCW.djhtm?c=1&etfid=DXCM.US&back=ACWI
AJG	ARTHUR J GALLAGHER	/etf/ea/ETZCW.djhtm?c=1&etfid=AJG.US&back=ACWI
	CRH PLC	
	ADYEN NV	
TDG	TRANSDIGM GROUP INC	/etf/ea/ETZCW.djhtm?c=1&etfid=TDG.US&back=ACWI
RSG	REPUBLIC SERVICES INC	/etf/ea/ETZCW.djhtm?c=1&etfid=RSG.US&back=ACWI
2318.HK&back=ACWI	PING AN INSURANCE (GROUP) CO OF CH	/etf/ea/ETZCW.djhtm?c=1&etfid=2318.HK&back=ACWI
6954.JP&back=ACWI	FANUC CORP	/etf/ea/ETZCW.djhtm?c=1&etfid=6954.JP&back=ACWI
CMI	CUMMINS INC	/etf/ea/ETZCW.djhtm?c=1&etfid=CMI.US&back=ACWI
	NASPERS LIMITED N LTD	
2269.HK&back=ACWI	WUXI BIOLOGICS CAYMAN INC	/etf/ea/ETZCW.djhtm?c=1&etfid=2269.HK&back=ACWI
PCAR	PACCAR INC	/etf/ea/ETZCW.djhtm?c=1&etfid=PCAR.US&back=ACWI
WDAY	WORKDAY INC CLASS A	/etf/ea/ETZCW.djhtm?c=1&etfid=WDAY.US&back=ACWI
HLT	HILTON WORLDWIDE HOLDINGS INC	/etf/ea/ETZCW.djhtm?c=1&etfid=HLT.US&back=ACWI
VICI	VICI PPTYS INC	/etf/ea/ETZCW.djhtm?c=1&etfid=VICI.US&back=ACWI
9434.JP&back=ACWI	SOFTBANK CORP	/etf/ea/ETZCW.djhtm?c=1&etfid=9434.JP&back=ACWI
	LONDON STOCK EXCHANGE GROUP PLC	
ROST	ROSS STORES INC	/etf/ea/ETZCW.djhtm?c=1&etfid=ROST.US&back=ACWI
PPG	PPG INDUSTRIES INC	/etf/ea/ETZCW.djhtm?c=1&etfid=PPG.US&back=ACWI
HPQ	HP INC	/etf/ea/ETZCW.djhtm?c=1&etfid=HPQ.US&back=ACWI
DLTR	DOLLAR TREE INC	/etf/ea/ETZCW.djhtm?c=1&etfid=DLTR.US&back=ACWI
8001.JP&back=ACWI	ITOCHU CORP	/etf/ea/ETZCW.djhtm?c=1&etfid=8001.JP&back=ACWI
	VOLKSWAGEN NON-VOTING PREF AG	
	CAPGEMINI	
	TWD CASH	
IDXX	IDEXX LABORATORIES INC	/etf/ea/ETZCW.djhtm?c=1&etfid=IDXX.US&back=ACWI
AMP	AMERIPRISE FINANCE INC	/etf/ea/ETZCW.djhtm?c=1&etfid=AMP.US&back=ACWI
6981.JP&back=ACWI	MURATA MANUFACTURING LTD	/etf/ea/ETZCW.djhtm?c=1&etfid=6981.JP&back=ACWI
	WOOLWORTHS GROUP LTD	
ILMN	ILLUMINA INC	/etf/ea/ETZCW.djhtm?c=1&etfid=ILMN.US&back=ACWI
KEYS	KEYSIGHT TECHNOLOGIES INC	/etf/ea/ETZCW.djhtm?c=1&etfid=KEYS.US&back=ACWI
	DSV	
	BARCLAYS PLC	
	ATLAS COPCO CLASS A	
ES	EVERSOURCE ENERGY	/etf/ea/ETZCW.djhtm?c=1&etfid=ES.US&back=ACWI
FAST	FASTENAL	/etf/ea/ETZCW.djhtm?c=1&etfid=FAST.US&back=ACWI
	BAE SYSTEMS PLC	
	TRANSURBAN GROUP STAPLED UNITS	
VRSK	VERISK ANALYTICS INC	/etf/ea/ETZCW.djhtm?c=1&etfid=VRSK.US&back=ACWI
	NORDEA BANK	
	EXPERIAN PLC	
AME	AMETEK INC	/etf/ea/ETZCW.djhtm?c=1&etfid=AME.US&back=ACWI
4661.JP&back=ACWI	ORIENTAL LAND LTD	/etf/ea/ETZCW.djhtm?c=1&etfid=4661.JP&back=ACWI
	HINDUSTAN UNILEVER LTD	
OKE	ONEOK INC	/etf/ea/ETZCW.djhtm?c=1&etfid=OKE.US&back=ACWI
WBD	WARNER BROS. DISCOVERY INC SERIES	/etf/ea/ETZCW.djhtm?c=1&etfid=WBD.US&back=ACWI
AVB	AVALONBAY COMMUNITIES REIT INC	/etf/ea/ETZCW.djhtm?c=1&etfid=AVB.US&back=ACWI
	KONINKLIJKE AHOLD DELHAIZE NV	
BAX	BAXTER INTERNATIONAL INC	/etf/ea/ETZCW.djhtm?c=1&etfid=BAX.US&back=ACWI
DFS	DISCOVER FINANCIAL SERVICES	/etf/ea/ETZCW.djhtm?c=1&etfid=DFS.US&back=ACWI
3382.JP&back=ACWI	SEVEN & I HOLDINGS LTD	/etf/ea/ETZCW.djhtm?c=1&etfid=3382.JP&back=ACWI
DD	DUPONT DE NEMOURS INC	/etf/ea/ETZCW.djhtm?c=1&etfid=DD.US&back=ACWI
AWK	AMERICAN WATER WORKS INC	/etf/ea/ETZCW.djhtm?c=1&etfid=AWK.US&back=ACWI
ANET	ARISTA NETWORKS INC	/etf/ea/ETZCW.djhtm?c=1&etfid=ANET.US&back=ACWI
6594.JP&back=ACWI	NIDEC CORP	/etf/ea/ETZCW.djhtm?c=1&etfid=6594.JP&back=ACWI
BIIB	BIOGEN INC	/etf/ea/ETZCW.djhtm?c=1&etfid=BIIB.US&back=ACWI
	ENI	
	BANCO BILBAO VIZCAYA ARGENTARIA SA	
VEEV	VEEVA SYSTEMS INC CLASS A	/etf/ea/ETZCW.djhtm?c=1&etfid=VEEV.US&back=ACWI
ON	ON SEMICONDUCTOR CORP	/etf/ea/ETZCW.djhtm?c=1&etfid=ON.US&back=ACWI
CSGP	COSTAR GROUP INC	/etf/ea/ETZCW.djhtm?c=1&etfid=CSGP.US&back=ACWI
EXR	EXTRA SPACE STORAGE REIT INC	/etf/ea/ETZCW.djhtm?c=1&etfid=EXR.US&back=ACWI
MTB	M&T BANK CORP	/etf/ea/ETZCW.djhtm?c=1&etfid=MTB.US&back=ACWI
	WOLTERS KLUWER NV	
	STELLANTIS NV	
IFF	INTERNATIONAL FLAVORS & FRAGRANCES	/etf/ea/ETZCW.djhtm?c=1&etfid=IFF.US&back=ACWI
ROK	ROCKWELL AUTOMATION INC	/etf/ea/ETZCW.djhtm?c=1&etfid=ROK.US&back=ACWI
NIO	NIO AMERICAN DEPOSITARY SHARES REP	/etf/ea/ETZCW.djhtm?c=1&etfid=NIO.US&back=ACWI
	FERGUSON PLC	
	NOKIA	
TTD	TRADE DESK INC CLASS A	/etf/ea/ETZCW.djhtm?c=1&etfid=TTD.US&back=ACWI
EBAY	EBAY INC	/etf/ea/ETZCW.djhtm?c=1&etfid=EBAY.US&back=ACWI
GLW	CORNING INC	/etf/ea/ETZCW.djhtm?c=1&etfid=GLW.US&back=ACWI
CBRE	CBRE GROUP INC CLASS A	/etf/ea/ETZCW.djhtm?c=1&etfid=CBRE.US&back=ACWI
	BAJAJ FINANCE LTD	
KKR	KKR AND CO INC	/etf/ea/ETZCW.djhtm?c=1&etfid=KKR.US&back=ACWI
FRC	FIRST REPUBLIC BANK	/etf/ea/ETZCW.djhtm?c=1&etfid=FRC.US&back=ACWI
CEG	CONSTELLATION ENERGY CORP	/etf/ea/ETZCW.djhtm?c=1&etfid=CEG.US&back=ACWI
8411.JP&back=ACWI	MIZUHO FINANCIAL GROUP INC	/etf/ea/ETZCW.djhtm?c=1&etfid=8411.JP&back=ACWI
EQR	EQUITY RESIDENTIAL REIT	/etf/ea/ETZCW.djhtm?c=1&etfid=EQR.US&back=ACWI
TROW	T ROWE PRICE GROUP INC	/etf/ea/ETZCW.djhtm?c=1&etfid=TROW.US&back=ACWI
	GIVAUDAN SA	
	PRUDENTIAL PLC	
	AMERICA MOVIL L	
3988.HK&back=ACWI	BANK OF CHINA LTD H	/etf/ea/ETZCW.djhtm?c=1&etfid=3988.HK&back=ACWI
HAL	HALLIBURTON	/etf/ea/ETZCW.djhtm?c=1&etfid=HAL.US&back=ACWI
4503.JP&back=ACWI	ASTELLAS PHARMA INC	/etf/ea/ETZCW.djhtm?c=1&etfid=4503.JP&back=ACWI
OTIS	OTIS WORLDWIDE CORP	/etf/ea/ETZCW.djhtm?c=1&etfid=OTIS.US&back=ACWI
	SUN LIFE FINANCIAL INC	
	BMW AG	
	ADIDAS N AG	
	INTESA SANPAOLO	
	VESTAS WIND SYSTEMS	
STT	STATE STREET CORP	/etf/ea/ETZCW.djhtm?c=1&etfid=STT.US&back=ACWI
	CENOVUS ENERGY INC	
EIX	EDISON INTERNATIONAL	/etf/ea/ETZCW.djhtm?c=1&etfid=EIX.US&back=ACWI
006400.KS&back=ACWI	SAMSUNG SDI LTD	/etf/ea/ETZCW.djhtm?c=1&etfid=006400.KS&back=ACWI
7733.JP&back=ACWI	OLYMPUS CORP	/etf/ea/ETZCW.djhtm?c=1&etfid=7733.JP&back=ACWI
ALNY	ALNYLAM PHARMACEUTICALS INC	/etf/ea/ETZCW.djhtm?c=1&etfid=ALNY.US&back=ACWI
WTW	WILLIS TOWERS WATSON PLC	/etf/ea/ETZCW.djhtm?c=1&etfid=WTW.US&back=ACWI
APTV	APTIV PLC	/etf/ea/ETZCW.djhtm?c=1&etfid=APTV.US&back=ACWI
TWTR	TWITTER INC	/etf/ea/ETZCW.djhtm?c=1&etfid=TWTR.US&back=ACWI
GWW	WW GRAINGER INC	/etf/ea/ETZCW.djhtm?c=1&etfid=GWW.US&back=ACWI
6273.JP&back=ACWI	SMC (JAPAN) CORP	/etf/ea/ETZCW.djhtm?c=1&etfid=6273.JP&back=ACWI
	BARRICK GOLD CORP	
CPRT	COPART INC	/etf/ea/ETZCW.djhtm?c=1&etfid=CPRT.US&back=ACWI
WBA	WALGREEN BOOTS ALLIANCE INC	/etf/ea/ETZCW.djhtm?c=1&etfid=WBA.US&back=ACWI
	BANK CENTRAL ASIA	
IT	GARTNER INC	/etf/ea/ETZCW.djhtm?c=1&etfid=IT.US&back=ACWI
WY	WEYERHAEUSER REIT	/etf/ea/ETZCW.djhtm?c=1&etfid=WY.US&back=ACWI
	FERRARI NV	
DHI	D R HORTON INC	/etf/ea/ETZCW.djhtm?c=1&etfid=DHI.US&back=ACWI
KHC	KRAFT HEINZ	/etf/ea/ETZCW.djhtm?c=1&etfid=KHC.US&back=ACWI
	RWE AG	
005380.KS&back=ACWI	HYUNDAI MOTOR	/etf/ea/ETZCW.djhtm?c=1&etfid=005380.KS&back=ACWI
MTD	METTLER TOLEDO INC	/etf/ea/ETZCW.djhtm?c=1&etfid=MTD.US&back=ACWI
AEE	AMEREN CORP	/etf/ea/ETZCW.djhtm?c=1&etfid=AEE.US&back=ACWI
	GENMAB	
1398.HK&back=ACWI	INDUSTRIAL AND COMMERCIAL BANK OF	/etf/ea/ETZCW.djhtm?c=1&etfid=1398.HK&back=ACWI
DDOG	DATADOG INC CLASS A	/etf/ea/ETZCW.djhtm?c=1&etfid=DDOG.US&back=ACWI
CTRA	COTERRA ENERGY INC	/etf/ea/ETZCW.djhtm?c=1&etfid=CTRA.US&back=ACWI
FITB	FIFTH THIRD BANCORP	/etf/ea/ETZCW.djhtm?c=1&etfid=FITB.US&back=ACWI
	QATAR NATIONAL BANK	
EPAM	EPAM SYSTEMS INC	/etf/ea/ETZCW.djhtm?c=1&etfid=EPAM.US&back=ACWI
	STMICROELECTRONICS NV	
051910.KS&back=ACWI	LG CHEM LTD	/etf/ea/ETZCW.djhtm?c=1&etfid=051910.KS&back=ACWI
	MERCK	
ABC	AMERISOURCEBERGEN CORP	/etf/ea/ETZCW.djhtm?c=1&etfid=ABC.US&back=ACWI
	KONINKILIJKE DSM NV	
	ASHTEAD GROUP PLC	
EFX	EQUIFAX INC	/etf/ea/ETZCW.djhtm?c=1&etfid=EFX.US&back=ACWI
ETR	ENTERGY CORP	/etf/ea/ETZCW.djhtm?c=1&etfid=ETR.US&back=ACWI
KDP	KEURIG DR PEPPER INC	/etf/ea/ETZCW.djhtm?c=1&etfid=KDP.US&back=ACWI
DTE	DTE ENERGY	/etf/ea/ETZCW.djhtm?c=1&etfid=DTE.US&back=ACWI
	AMADEUS IT GROUP SA	
ODFL	OLD DOMINION FREIGHT LINE INC	/etf/ea/ETZCW.djhtm?c=1&etfid=ODFL.US&back=ACWI
BF.B	BROWN FORMAN CORP CLASS B	/etf/ea/ETZCW.djhtm?c=1&etfid=BF.B.US&back=ACWI
	HEINEKEN NV	
	VOLVO CLASS B	
	FRANCO NEVADA CORP	
	BHARTI AIRTEL LTD	
SIVB	SVB FINANCIAL GROUP	/etf/ea/ETZCW.djhtm?c=1&etfid=SIVB.US&back=ACWI
	DUKE REALTY REIT CORP	
	INDUSTRIA DE DISENO TEXTIL INDITEX	
VMW	VMWARE CLASS A INC	/etf/ea/ETZCW.djhtm?c=1&etfid=VMW.US&back=ACWI
	SWISS RE AG	
	BANCO BRADESCO PREF SA	
WST	WEST PHARMACEUTICAL SERVICES INC	/etf/ea/ETZCW.djhtm?c=1&etfid=WST.US&back=ACWI
VMC	VULCAN MATERIALS	/etf/ea/ETZCW.djhtm?c=1&etfid=VMC.US&back=ACWI
LYB	LYONDELLBASELL INDUSTRIES NV CLASS	/etf/ea/ETZCW.djhtm?c=1&etfid=LYB.US&back=ACWI
URI	UNITED RENTALS INC	/etf/ea/ETZCW.djhtm?c=1&etfid=URI.US&back=ACWI
TSN	TYSON FOODS INC CLASS A	/etf/ea/ETZCW.djhtm?c=1&etfid=TSN.US&back=ACWI
MLM	MARTIN MARIETTA MATERIALS INC	/etf/ea/ETZCW.djhtm?c=1&etfid=MLM.US&back=ACWI
035420.KS&back=ACWI	NAVER CORP	/etf/ea/ETZCW.djhtm?c=1&etfid=035420.KS&back=ACWI
6902.JP&back=ACWI	DENSO CORP	/etf/ea/ETZCW.djhtm?c=1&etfid=6902.JP&back=ACWI
6702.JP&back=ACWI	FUJITSU LTD	/etf/ea/ETZCW.djhtm?c=1&etfid=6702.JP&back=ACWI
	GOODMAN GROUP UNITS	
4452.JP&back=ACWI	KAO CORP	/etf/ea/ETZCW.djhtm?c=1&etfid=4452.JP&back=ACWI
	HEXAGON CLASS B	
BKR	BAKER HUGHES CLASS A	/etf/ea/ETZCW.djhtm?c=1&etfid=BKR.US&back=ACWI
LH	LABORATORY CORPORATION OF AMERICA	/etf/ea/ETZCW.djhtm?c=1&etfid=LH.US&back=ACWI
	SAMPO	
CF	CF INDUSTRIES HOLDINGS INC	/etf/ea/ETZCW.djhtm?c=1&etfid=CF.US&back=ACWI
YUMC	YUM CHINA HOLDINGS INC	/etf/ea/ETZCW.djhtm?c=1&etfid=YUMC.US&back=ACWI
	ITAU UNIBANCO HOLDING PREF SA	
	HOLCIM LTD AG	
HIG	HARTFORD FINANCIAL SERVICES GROUP	/etf/ea/ETZCW.djhtm?c=1&etfid=HIG.US&back=ACWI
	ENGIE SA	
	OVERSEA-CHINESE BANKING LTD	
	ERICSSON B	
ZBH	ZIMMER BIOMET HOLDINGS INC	/etf/ea/ETZCW.djhtm?c=1&etfid=ZBH.US&back=ACWI
SE	SEA ADS REPRESENTING LTD CLASS A	/etf/ea/ETZCW.djhtm?c=1&etfid=SE.US&back=ACWI
ULTA	ULTA BEAUTY INC	/etf/ea/ETZCW.djhtm?c=1&etfid=ULTA.US&back=ACWI
	DASSAULT SYSTEMES	
MKC	MCCORMICK & CO NON-VOTING INC	/etf/ea/ETZCW.djhtm?c=1&etfid=MKC.US&back=ACWI
7751.JP&back=ACWI	CANON INC	/etf/ea/ETZCW.djhtm?c=1&etfid=7751.JP&back=ACWI
	TELEFONICA SA	
MDB	MONGODB INC CLASS A	/etf/ea/ETZCW.djhtm?c=1&etfid=MDB.US&back=ACWI
CHD	CHURCH AND DWIGHT INC	/etf/ea/ETZCW.djhtm?c=1&etfid=CHD.US&back=ACWI
	EMIRATES TELECOM	
	COMPAGNIE DE SAINT GOBAIN SA	
FE	FIRSTENERGY CORP	/etf/ea/ETZCW.djhtm?c=1&etfid=FE.US&back=ACWI
RF	REGIONS FINANCIAL CORP	/etf/ea/ETZCW.djhtm?c=1&etfid=RF.US&back=ACWI
ARE	ALEXANDRIA REAL ESTATE EQUITIES RE	/etf/ea/ETZCW.djhtm?c=1&etfid=ARE.US&back=ACWI
1810.HK&back=ACWI	XIAOMI CORP	/etf/ea/ETZCW.djhtm?c=1&etfid=1810.HK&back=ACWI
	THOMSON REUTERS CORP	
FANG	DIAMONDBACK ENERGY INC	/etf/ea/ETZCW.djhtm?c=1&etfid=FANG.US&back=ACWI
	NESTE	
PPL	PPL CORP	/etf/ea/ETZCW.djhtm?c=1&etfid=PPL.US&back=ACWI
	KERRY GROUP PLC	
	REPSOL SA	
	PEMBINA PIPELINE CORP	
600519.SH&back=ACWI	KWEICHOW MOUTAI LTD A	/etf/ea/ETZCW.djhtm?c=1&etfid=600519.SH&back=ACWI
FTV	FORTIVE CORP	/etf/ea/ETZCW.djhtm?c=1&etfid=FTV.US&back=ACWI
	LEGRAND SA	
APO	APOLLO GLOBAL MANAGEMENT INC	/etf/ea/ETZCW.djhtm?c=1&etfid=APO.US&back=ACWI
TSCO	TRACTOR SUPPLY	/etf/ea/ETZCW.djhtm?c=1&etfid=TSCO.US&back=ACWI
CAH	CARDINAL HEALTH INC	/etf/ea/ETZCW.djhtm?c=1&etfid=CAH.US&back=ACWI
LEN	LENNAR A CORP	/etf/ea/ETZCW.djhtm?c=1&etfid=LEN.US&back=ACWI
	FORTESCUE METALS GROUP LTD	
4543.JP&back=ACWI	TERUMO CORP	/etf/ea/ETZCW.djhtm?c=1&etfid=4543.JP&back=ACWI
	PARTNERS GROUP HOLDING AG	
2331.HK&back=ACWI	LI NING LTD	/etf/ea/ETZCW.djhtm?c=1&etfid=2331.HK&back=ACWI
SGEN	SEAGEN INC	/etf/ea/ETZCW.djhtm?c=1&etfid=SGEN.US&back=ACWI
1211.HK&back=ACWI	BYD LTD H	/etf/ea/ETZCW.djhtm?c=1&etfid=1211.HK&back=ACWI
	IMPERIAL BRANDS PLC	
	TESCO PLC	
	FIRST ABU DHABI BANK	
	UNICREDIT	
	ASSA ABLOY B	
MAA	MID AMERICA APARTMENT COMMUNITIES	/etf/ea/ETZCW.djhtm?c=1&etfid=MAA.US&back=ACWI
5108.JP&back=ACWI	BRIDGESTONE CORP	/etf/ea/ETZCW.djhtm?c=1&etfid=5108.JP&back=ACWI
CMS	CMS ENERGY CORP	/etf/ea/ETZCW.djhtm?c=1&etfid=CMS.US&back=ACWI
8591.JP&back=ACWI	ORIX CORP	/etf/ea/ETZCW.djhtm?c=1&etfid=8591.JP&back=ACWI
CDW	CDW CORP	/etf/ea/ETZCW.djhtm?c=1&etfid=CDW.US&back=ACWI
	SSE PLC	
PFG	PRINCIPAL FINANCIAL GROUP INC	/etf/ea/ETZCW.djhtm?c=1&etfid=PFG.US&back=ACWI
MPWR	MONOLITHIC POWER SYSTEMS INC	/etf/ea/ETZCW.djhtm?c=1&etfid=MPWR.US&back=ACWI
NTRS	NORTHERN TRUST CORP	/etf/ea/ETZCW.djhtm?c=1&etfid=NTRS.US&back=ACWI
	ALINMA BANK	
MOS	MOSAIC	/etf/ea/ETZCW.djhtm?c=1&etfid=MOS.US&back=ACWI
	E.ON N	
	VONOVIA SE	
VRSN	VERISIGN INC	/etf/ea/ETZCW.djhtm?c=1&etfid=VRSN.US&back=ACWI
	PETROLEO BRASILEIRO SA PETROBRAS	
	DOLLARAMA INC	
	BANK RAKYAT INDONESIA (PERSERO)	
	ARGENX	
WAT	WATERS CORP	/etf/ea/ETZCW.djhtm?c=1&etfid=WAT.US&back=ACWI
	ASIAN PAINTS LTD	
6971.JP&back=ACWI	KYOCERA CORP	/etf/ea/ETZCW.djhtm?c=1&etfid=6971.JP&back=ACWI
6178.JP&back=ACWI	JAPAN POST HOLDINGS LTD	/etf/ea/ETZCW.djhtm?c=1&etfid=6178.JP&back=ACWI
	FLUTTER ENTERTAINMENT PLC	
AMCR	AMCOR PLC	/etf/ea/ETZCW.djhtm?c=1&etfid=AMCR.US&back=ACWI
	SANTOS LTD	
8002.JP&back=ACWI	MARUBENI CORP	/etf/ea/ETZCW.djhtm?c=1&etfid=8002.JP&back=ACWI
DOV	DOVER CORP	/etf/ea/ETZCW.djhtm?c=1&etfid=DOV.US&back=ACWI
2914.JP&back=ACWI	JAPAN TOBACCO INC	/etf/ea/ETZCW.djhtm?c=1&etfid=2914.JP&back=ACWI
	CELLNEX TELECOM SA	
	GEBERIT AG	
	UPM-KYMMENE	
VTR	VENTAS REIT INC	/etf/ea/ETZCW.djhtm?c=1&etfid=VTR.US&back=ACWI
	AXIS BANK LTD	
	COMPAGNIE GENERALE DES ETABLISSEME	
	INTACT FINANCIAL CORP	
	BRL CASH	
HPE	HEWLETT PACKARD ENTERPRISE	/etf/ea/ETZCW.djhtm?c=1&etfid=HPE.US&back=ACWI
BALL	BALL CORP	/etf/ea/ETZCW.djhtm?c=1&etfid=BALL.US&back=ACWI
ALGN	ALIGN TECHNOLOGY INC	/etf/ea/ETZCW.djhtm?c=1&etfid=ALGN.US&back=ACWI
PAYC	PAYCOM SOFTWARE INC	/etf/ea/ETZCW.djhtm?c=1&etfid=PAYC.US&back=ACWI
	NATIONAL BANK OF CANADA	
	RIYAD BANK	
4901.JP&back=ACWI	FUJIFILM HOLDINGS CORP	/etf/ea/ETZCW.djhtm?c=1&etfid=4901.JP&back=ACWI
	RIO TINTO LTD	
	STANDARD CHARTERED PLC	
	DNB BANK	
TTWO	TAKE TWO INTERACTIVE SOFTWARE INC	/etf/ea/ETZCW.djhtm?c=1&etfid=TTWO.US&back=ACWI
	TOURMALINE OIL CORP	
PCG	PG&E CORP	/etf/ea/ETZCW.djhtm?c=1&etfid=PCG.US&back=ACWI
CLX	CLOROX	/etf/ea/ETZCW.djhtm?c=1&etfid=CLX.US&back=ACWI
	SANDVIK	
EXPD	EXPEDITORS INTERNATIONAL OF WASHIN	/etf/ea/ETZCW.djhtm?c=1&etfid=EXPD.US&back=ACWI
ESS	ESSEX PROPERTY TRUST REIT INC	/etf/ea/ETZCW.djhtm?c=1&etfid=ESS.US&back=ACWI
	LEGAL AND GENERAL GROUP PLC	
6503.JP&back=ACWI	MITSUBISHI ELECTRIC CORP	/etf/ea/ETZCW.djhtm?c=1&etfid=6503.JP&back=ACWI
AES	AES CORP	/etf/ea/ETZCW.djhtm?c=1&etfid=AES.US&back=ACWI
PWR	QUANTA SERVICES INC	/etf/ea/ETZCW.djhtm?c=1&etfid=PWR.US&back=ACWI
ANSS	ANSYS INC	/etf/ea/ETZCW.djhtm?c=1&etfid=ANSS.US&back=ACWI
	UNITED OVERSEAS BANK LTD	
8750.JP&back=ACWI	DAI-ICHI LIFE HOLDINGS INC	/etf/ea/ETZCW.djhtm?c=1&etfid=8750.JP&back=ACWI
6301.JP&back=ACWI	KOMATSU LTD	/etf/ea/ETZCW.djhtm?c=1&etfid=6301.JP&back=ACWI
RJF	RAYMOND JAMES INC	/etf/ea/ETZCW.djhtm?c=1&etfid=RJF.US&back=ACWI
IR	INGERSOLL RAND INC	/etf/ea/ETZCW.djhtm?c=1&etfid=IR.US&back=ACWI
MOH	MOLINA HEALTHCARE INC	/etf/ea/ETZCW.djhtm?c=1&etfid=MOH.US&back=ACWI
6752.JP&back=ACWI	PANASONIC HOLDINGS CORP	/etf/ea/ETZCW.djhtm?c=1&etfid=6752.JP&back=ACWI
XYL	XYLEM INC	/etf/ea/ETZCW.djhtm?c=1&etfid=XYL.US&back=ACWI
CAG	CONAGRA BRANDS INC	/etf/ea/ETZCW.djhtm?c=1&etfid=CAG.US&back=ACWI
	WALMART DE MEXICO V	
	AGNICO EAGLE MINES LTD	
NTAP	NETAPP INC	/etf/ea/ETZCW.djhtm?c=1&etfid=NTAP.US&back=ACWI
	SAUDI ARABIAN OIL	
GPC	GENUINE PARTS	/etf/ea/ETZCW.djhtm?c=1&etfid=GPC.US&back=ACWI
	SAUDI BASIC INDUSTRIES	
TRMB	TRIMBLE INC	/etf/ea/ETZCW.djhtm?c=1&etfid=TRMB.US&back=ACWI
4519.JP&back=ACWI	CHUGAI PHARMACEUTICAL LTD	/etf/ea/ETZCW.djhtm?c=1&etfid=4519.JP&back=ACWI
	NATIONAL BANK OF KUWAIT	
ZM	ZOOM VIDEO COMMUNICATIONS INC CLAS	/etf/ea/ETZCW.djhtm?c=1&etfid=ZM.US&back=ACWI
	TECK RESOURCES SUBORDINATE VOTING	
3968.HK&back=ACWI	CHINA MERCHANTS BANK LTD H	/etf/ea/ETZCW.djhtm?c=1&etfid=3968.HK&back=ACWI
	DEUTSCHE BANK AG	
	ORSTED	
NDAQ	NASDAQ INC	/etf/ea/ETZCW.djhtm?c=1&etfid=NDAQ.US&back=ACWI
	MAGNA INTERNATIONAL INC	
	FORTIS INC	
BMRN	BIOMARIN PHARMACEUTICAL INC	/etf/ea/ETZCW.djhtm?c=1&etfid=BMRN.US&back=ACWI
	EDP ENERGIAS DE PORTUGAL SA	
	POWER CORPORATION OF CANADA	
	EPIROC CLASS A	
PODD	INSULET CORP	/etf/ea/ETZCW.djhtm?c=1&etfid=PODD.US&back=ACWI
SYF	SYNCHRONY FINANCIAL	/etf/ea/ETZCW.djhtm?c=1&etfid=SYF.US&back=ACWI
KEY	KEYCORP	/etf/ea/ETZCW.djhtm?c=1&etfid=KEY.US&back=ACWI
	RESTAURANTS BRANDS INTERNATIONAL I	
0001.HK&back=ACWI	CK HUTCHISON HOLDINGS LTD	/etf/ea/ETZCW.djhtm?c=1&etfid=0001.HK&back=ACWI
BR	BROADRIDGE FINANCIAL SOLUTIONS INC	/etf/ea/ETZCW.djhtm?c=1&etfid=BR.US&back=ACWI
LNT	ALLIANT ENERGY CORP	/etf/ea/ETZCW.djhtm?c=1&etfid=LNT.US&back=ACWI
SWKS	SKYWORKS SOLUTIONS INC	/etf/ea/ETZCW.djhtm?c=1&etfid=SWKS.US&back=ACWI
	LARSEN AND TOUBRO LTD	
	ROGERS COMMUNICATIONS NON-VOTING I	
8053.JP&back=ACWI	SUMITOMO CORP	/etf/ea/ETZCW.djhtm?c=1&etfid=8053.JP&back=ACWI
	COLES GROUP LTD	
	SOCIETE GENERALE SA	
STE	STERIS	/etf/ea/ETZCW.djhtm?c=1&etfid=STE.US&back=ACWI
FLT	FLEETCOR TECHNOLOGIES INC	/etf/ea/ETZCW.djhtm?c=1&etfid=FLT.US&back=ACWI
	SAUDI TELECOM	
0016.HK&back=ACWI	SUN HUNG KAI PROPERTIES LTD	/etf/ea/ETZCW.djhtm?c=1&etfid=0016.HK&back=ACWI
	GPO FINANCE BANORTE	
8801.JP&back=ACWI	MITSUI FUDOSAN LTD	/etf/ea/ETZCW.djhtm?c=1&etfid=8801.JP&back=ACWI
	CAD CASH	
DRI	DARDEN RESTAURANTS INC	/etf/ea/ETZCW.djhtm?c=1&etfid=DRI.US&back=ACWI
6326.JP&back=ACWI	KUBOTA CORP	/etf/ea/ETZCW.djhtm?c=1&etfid=6326.JP&back=ACWI
0823.HK&back=ACWI	LINK REAL ESTATE INVESTMENT TRUST	/etf/ea/ETZCW.djhtm?c=1&etfid=0823.HK&back=ACWI
	MARUTI SUZUKI INDIA LTD	
CFG	CITIZENS FINANCIAL GROUP INC	/etf/ea/ETZCW.djhtm?c=1&etfid=CFG.US&back=ACWI
J	JACOBS SOLUTIONS INC	/etf/ea/ETZCW.djhtm?c=1&etfid=J.US&back=ACWI
	VEOLIA ENVIRON. SA	
BRO	BROWN & BROWN INC	/etf/ea/ETZCW.djhtm?c=1&etfid=BRO.US&back=ACWI
	MASRAF AL RAYAN	
LI	LI AUTO ADRINC	/etf/ea/ETZCW.djhtm?c=1&etfid=LI.US&back=ACWI
000270.KS&back=ACWI	KIA CORPORATION CORP	/etf/ea/ETZCW.djhtm?c=1&etfid=000270.KS&back=ACWI
ZBRA	ZEBRA TECHNOLOGIES CORP CLASS A	/etf/ea/ETZCW.djhtm?c=1&etfid=ZBRA.US&back=ACWI
TDY	TELEDYNE TECHNOLOGIES INC	/etf/ea/ETZCW.djhtm?c=1&etfid=TDY.US&back=ACWI
	HKD CASH	
IP	INTERNATIONAL PAPER	/etf/ea/ETZCW.djhtm?c=1&etfid=IP.US&back=ACWI
	SAUDI ARABIAN MINING	
035720.KS&back=ACWI	KAKAO CORP	/etf/ea/ETZCW.djhtm?c=1&etfid=035720.KS&back=ACWI
	SKANDINAVISKA ENSKILDA BANKEN	
	A P MOLLER MAERSK	
	TELUS CORP	
	3I GROUP PLC	
INVH	INVITATION HOMES INC	/etf/ea/ETZCW.djhtm?c=1&etfid=INVH.US&back=ACWI
	ARISTOCRAT LEISURE LTD	
NET	CLOUDFLARE INC CLASS A	/etf/ea/ETZCW.djhtm?c=1&etfid=NET.US&back=ACWI
LPLA	LPL FINANCIAL HOLDINGS INC	/etf/ea/ETZCW.djhtm?c=1&etfid=LPLA.US&back=ACWI
WAB	WESTINGHOUSE AIR BRAKE TECHNOLOGIE	/etf/ea/ETZCW.djhtm?c=1&etfid=WAB.US&back=ACWI
0669.HK&back=ACWI	TECHTRONIC INDUSTRIES LTD	/etf/ea/ETZCW.djhtm?c=1&etfid=0669.HK&back=ACWI
HRL	HORMEL FOODS CORP	/etf/ea/ETZCW.djhtm?c=1&etfid=HRL.US&back=ACWI
LBRDK	LIBERTY BROADBAND CORP SERIES C	/etf/ea/ETZCW.djhtm?c=1&etfid=LBRDK.US&back=ACWI
DGX	QUEST DIAGNOSTICS INC	/etf/ea/ETZCW.djhtm?c=1&etfid=DGX.US&back=ACWI
	KOTAK MAHINDRA BANK LTD	
AKAM	AKAMAI TECHNOLOGIES INC	/etf/ea/ETZCW.djhtm?c=1&etfid=AKAM.US&back=ACWI
LKQ	LKQ CORP	/etf/ea/ETZCW.djhtm?c=1&etfid=LKQ.US&back=ACWI
EQT	EQT CORP	/etf/ea/ETZCW.djhtm?c=1&etfid=EQT.US&back=ACWI
2303.TW&back=ACWI	UNITED MICRO ELECTRONICS CORP	/etf/ea/ETZCW.djhtm?c=1&etfid=2303.TW&back=ACWI
	FIRSTRAND LTD	
	SONOVA HOLDING AG	
PEAK	HEALTHPEAK PROPERTIES INC	/etf/ea/ETZCW.djhtm?c=1&etfid=PEAK.US&back=ACWI
	FERROVIAL SA	
	SWEDISH MATCH	
K	KELLOGG	/etf/ea/ETZCW.djhtm?c=1&etfid=K.US&back=ACWI
	EDENRED	
	TERNA RETE ELETTRICA NAZIONALE	
MTCH	MATCH GROUP INC	/etf/ea/ETZCW.djhtm?c=1&etfid=MTCH.US&back=ACWI
OMC	OMNICOM GROUP INC	/etf/ea/ETZCW.djhtm?c=1&etfid=OMC.US&back=ACWI
	SOCIEDAD QUIMICA Y MINERA DE CHILE	
	UNIVERSAL MUSIC GROUP NV	
ACGL	ARCH CAPITAL GROUP LTD	/etf/ea/ETZCW.djhtm?c=1&etfid=ACGL.US&back=ACWI
	IMPERIAL OIL LTD	
HUBS	HUBSPOT INC	/etf/ea/ETZCW.djhtm?c=1&etfid=HUBS.US&back=ACWI
BBY	BEST BUY INC	/etf/ea/ETZCW.djhtm?c=1&etfid=BBY.US&back=ACWI
1024.HK&back=ACWI	KUAISHOU TECHNOLOGY	/etf/ea/ETZCW.djhtm?c=1&etfid=1024.HK&back=ACWI
SPLK	SPLUNK INC	/etf/ea/ETZCW.djhtm?c=1&etfid=SPLK.US&back=ACWI
	KUWAIT FINANCE HOUSE	
SUI	SUN COMMUNITIES REIT INC	/etf/ea/ETZCW.djhtm?c=1&etfid=SUI.US&back=ACWI
CHRW	CH ROBINSON WORLDWIDE INC	/etf/ea/ETZCW.djhtm?c=1&etfid=CHRW.US&back=ACWI
KMX	CARMAX INC	/etf/ea/ETZCW.djhtm?c=1&etfid=KMX.US&back=ACWI
HWM	HOWMET AEROSPACE INC	/etf/ea/ETZCW.djhtm?c=1&etfid=HWM.US&back=ACWI
9022.JP&back=ACWI	CENTRAL JAPAN RAILWAY	/etf/ea/ETZCW.djhtm?c=1&etfid=9022.JP&back=ACWI
4911.JP&back=ACWI	SHISEIDO LTD	/etf/ea/ETZCW.djhtm?c=1&etfid=4911.JP&back=ACWI
2884.TW&back=ACWI	E.SUN FINANCIAL HOLDING LTD	/etf/ea/ETZCW.djhtm?c=1&etfid=2884.TW&back=ACWI
1303.TW&back=ACWI	NAN YA PLASTICS CORP	/etf/ea/ETZCW.djhtm?c=1&etfid=1303.TW&back=ACWI
PKI	PERKINELMER INC	/etf/ea/ETZCW.djhtm?c=1&etfid=PKI.US&back=ACWI
	KONINKLIJKE PHILIPS NV	
2502.JP&back=ACWI	ASAHI GROUP HOLDINGS LTD	/etf/ea/ETZCW.djhtm?c=1&etfid=2502.JP&back=ACWI
FMC	FMC CORP	/etf/ea/ETZCW.djhtm?c=1&etfid=FMC.US&back=ACWI
TRU	TRANSUNION	/etf/ea/ETZCW.djhtm?c=1&etfid=TRU.US&back=ACWI
	NICE LTD	
IEX	IDEX CORP	/etf/ea/ETZCW.djhtm?c=1&etfid=IEX.US&back=ACWI
EXPE	EXPEDIA GROUP INC	/etf/ea/ETZCW.djhtm?c=1&etfid=EXPE.US&back=ACWI
BILL	BILL COM HOLDINGS INC	/etf/ea/ETZCW.djhtm?c=1&etfid=BILL.US&back=ACWI
	B3 BRASIL BOLSA BALCAO SA	
	WHEATON PRECIOUS METALS CORP	
CTLT	CATALENTINC	/etf/ea/ETZCW.djhtm?c=1&etfid=CTLT.US&back=ACWI
	SOUTH32 LTD	
PLUG	PLUG POWER INC	/etf/ea/ETZCW.djhtm?c=1&etfid=PLUG.US&back=ACWI
2412.TW&back=ACWI	CHUNGHWA TELECOM LTD	/etf/ea/ETZCW.djhtm?c=1&etfid=2412.TW&back=ACWI
068270.KS&back=ACWI	CELLTRION INC	/etf/ea/ETZCW.djhtm?c=1&etfid=068270.KS&back=ACWI
	HALEON PLC	
	ASSICURAZIONI GENERALI	
2308.TW&back=ACWI	DELTA ELECTRONICS INC	/etf/ea/ETZCW.djhtm?c=1&etfid=2308.TW&back=ACWI
	CARLSBERG ASCL B	
CBOE	CBOE GLOBAL MARKETS INC	/etf/ea/ETZCW.djhtm?c=1&etfid=CBOE.US&back=ACWI
MRO	MARATHON OIL CORP	/etf/ea/ETZCW.djhtm?c=1&etfid=MRO.US&back=ACWI
	SWISSCOM AG	
TER	TERADYNE INC	/etf/ea/ETZCW.djhtm?c=1&etfid=TER.US&back=ACWI
STX	SEAGATE TECHNOLOGY HOLDINGS PLC	/etf/ea/ETZCW.djhtm?c=1&etfid=STX.US&back=ACWI
HOLX	HOLOGIC INC	/etf/ea/ETZCW.djhtm?c=1&etfid=HOLX.US&back=ACWI
8802.JP&back=ACWI	MITSUBISHI ESTATE CO LTD	/etf/ea/ETZCW.djhtm?c=1&etfid=8802.JP&back=ACWI
	ADANI TRANSMISSION LTD	
0002.HK&back=ACWI	CLP HOLDINGS LTD	/etf/ea/ETZCW.djhtm?c=1&etfid=0002.HK&back=ACWI
1113.HK&back=ACWI	CK ASSET HOLDINGS LTD	/etf/ea/ETZCW.djhtm?c=1&etfid=1113.HK&back=ACWI
2413.JP&back=ACWI	M3 INC	/etf/ea/ETZCW.djhtm?c=1&etfid=2413.JP&back=ACWI
DPZ	DOMINOS PIZZA INC	/etf/ea/ETZCW.djhtm?c=1&etfid=DPZ.US&back=ACWI
SEDG	SOLAREDGE TECHNOLOGIES INC	/etf/ea/ETZCW.djhtm?c=1&etfid=SEDG.US&back=ACWI
	EVOLUTION	
	FAIRFAX FINANCIAL HOLDINGS SUB VOT	
	ORANGE SA	
GNRC	GENERAC HOLDINGS INC	/etf/ea/ETZCW.djhtm?c=1&etfid=GNRC.US&back=ACWI
TYL	TYLER TECHNOLOGIES INC	/etf/ea/ETZCW.djhtm?c=1&etfid=TYL.US&back=ACWI
	CNH INDUSTRIAL NV	
6502.JP&back=ACWI	TOSHIBA CORP	/etf/ea/ETZCW.djhtm?c=1&etfid=6502.JP&back=ACWI
FWONK	LIBERTY MEDIA FORMULA ONE CORP SER	/etf/ea/ETZCW.djhtm?c=1&etfid=FWONK.US&back=ACWI
WRB	WR BERKLEY CORP	/etf/ea/ETZCW.djhtm?c=1&etfid=WRB.US&back=ACWI
7832.JP&back=ACWI	BANDAI NAMCO HOLDINGS INC	/etf/ea/ETZCW.djhtm?c=1&etfid=7832.JP&back=ACWI
IRM	IRON MOUNTAIN INC	/etf/ea/ETZCW.djhtm?c=1&etfid=IRM.US&back=ACWI
	GRUPO MEXICO B	
8113.JP&back=ACWI	UNICHARM CORP	/etf/ea/ETZCW.djhtm?c=1&etfid=8113.JP&back=ACWI
105560.KS&back=ACWI	KB FINANCIAL GROUP INC	/etf/ea/ETZCW.djhtm?c=1&etfid=105560.KS&back=ACWI
TXT	TEXTRON INC	/etf/ea/ETZCW.djhtm?c=1&etfid=TXT.US&back=ACWI
UDR	UDR REIT INC	/etf/ea/ETZCW.djhtm?c=1&etfid=UDR.US&back=ACWI
2319.HK&back=ACWI	CHINA MENGNIU DAIRY LTD	/etf/ea/ETZCW.djhtm?c=1&etfid=2319.HK&back=ACWI
ATO	ATMOS ENERGY CORP	/etf/ea/ETZCW.djhtm?c=1&etfid=ATO.US&back=ACWI
NLOK	NORTONLIFELOCK INC	/etf/ea/ETZCW.djhtm?c=1&etfid=NLOK.US&back=ACWI
	MAHINDRA AND MAHINDRA LTD	
2891.TW&back=ACWI	CTBC FINANCIAL HOLDING LTD	/etf/ea/ETZCW.djhtm?c=1&etfid=2891.TW&back=ACWI
	HCL TECHNOLOGIES LTD	
BAH	BOOZ ALLEN HAMILTON HOLDING CORP C	/etf/ea/ETZCW.djhtm?c=1&etfid=BAH.US&back=ACWI
	BRAMBLES LTD	
MAS	MASCO CORP	/etf/ea/ETZCW.djhtm?c=1&etfid=MAS.US&back=ACWI
	ITC LTD	
	CHOCOLADEFABRIKEN LINDT & SPRUENGL	
INCY	INCYTE CORP	/etf/ea/ETZCW.djhtm?c=1&etfid=INCY.US&back=ACWI
	NIBE INDUSTRIER CLASS B	
2881.TW&back=ACWI	FUBON FINANCIAL HOLDING LTD	/etf/ea/ETZCW.djhtm?c=1&etfid=2881.TW&back=ACWI
	CAPITALAND INVESTMENT LTD	
005490.KS&back=ACWI	POSCO	/etf/ea/ETZCW.djhtm?c=1&etfid=005490.KS&back=ACWI
TCOM	TRIP COM GROUP ADR LTD	/etf/ea/ETZCW.djhtm?c=1&etfid=TCOM.US&back=ACWI
PARA	PARAMOUNT GLOBAL CLASS B	/etf/ea/ETZCW.djhtm?c=1&etfid=PARA.US&back=ACWI
AVTR	AVANTOR INC	/etf/ea/ETZCW.djhtm?c=1&etfid=AVTR.US&back=ACWI
	CGI INC	
2020.HK&back=ACWI	ANTA SPORTS PRODUCTS LTD	/etf/ea/ETZCW.djhtm?c=1&etfid=2020.HK&back=ACWI
	PUBLICIS GROUPE SA	
ZS	ZSCALER INC	/etf/ea/ETZCW.djhtm?c=1&etfid=ZS.US&back=ACWI
	AMBEV SA	
ETSY	ETSY INC	/etf/ea/ETZCW.djhtm?c=1&etfid=ETSY.US&back=ACWI
STLD	STEEL DYNAMICS INC	/etf/ea/ETZCW.djhtm?c=1&etfid=STLD.US&back=ACWI
	FOMENTO ECONOMICO MEXICANO	
BG	BUNGE LTD	/etf/ea/ETZCW.djhtm?c=1&etfid=BG.US&back=ACWI
	TELEKOMUNIKASI INDONESIA	
GDDY	GODADDY INC CLASS A	/etf/ea/ETZCW.djhtm?c=1&etfid=GDDY.US&back=ACWI
	STATE BANK OF INDIA	
	ESSITY CLASS B	
FDS	FACTSET RESEARCH SYSTEMS INC	/etf/ea/ETZCW.djhtm?c=1&etfid=FDS.US&back=ACWI
	SINGAPORE TELECOMMUNICATIONS LTD	
	KUEHNE UND NAGEL INTERNATIONAL AG	
	ADANI TOTAL GAS LTD	
2503.JP&back=ACWI	KIRIN HOLDINGS LTD	/etf/ea/ETZCW.djhtm?c=1&etfid=2503.JP&back=ACWI
	JULIUS BAER GRUPPE AG	
2882.TW&back=ACWI	CATHAY FINANCIAL HOLDING LTD	/etf/ea/ETZCW.djhtm?c=1&etfid=2882.TW&back=ACWI
HST	HOST HOTELS & RESORTS REIT INC	/etf/ea/ETZCW.djhtm?c=1&etfid=HST.US&back=ACWI
	CASH COLLATERAL USD SGAFT	
LDOS	LEIDOS HOLDINGS INC	/etf/ea/ETZCW.djhtm?c=1&etfid=LDOS.US&back=ACWI
	QBE INSURANCE GROUP LTD	
	MTN GROUP LTD	
6762.JP&back=ACWI	TDK CORP	/etf/ea/ETZCW.djhtm?c=1&etfid=6762.JP&back=ACWI
9020.JP&back=ACWI	EAST JAPAN RAILWAY	/etf/ea/ETZCW.djhtm?c=1&etfid=9020.JP&back=ACWI
SJM	JM SMUCKER	/etf/ea/ETZCW.djhtm?c=1&etfid=SJM.US&back=ACWI
OKTA	OKTA INC CLASS A	/etf/ea/ETZCW.djhtm?c=1&etfid=OKTA.US&back=ACWI
LYV	LIVE NATION ENTERTAINMENT INC	/etf/ea/ETZCW.djhtm?c=1&etfid=LYV.US&back=ACWI
5401.JP&back=ACWI	NIPPON STEEL CORP	/etf/ea/ETZCW.djhtm?c=1&etfid=5401.JP&back=ACWI
MKL	MARKEL CORP	/etf/ea/ETZCW.djhtm?c=1&etfid=MKL.US&back=ACWI
	AKZO NOBEL NV	
WDC	WESTERN DIGITAL CORP	/etf/ea/ETZCW.djhtm?c=1&etfid=WDC.US&back=ACWI
8725.JP&back=ACWI	MS&AD INSURANCE GROUP HOLDINGS INC	/etf/ea/ETZCW.djhtm?c=1&etfid=8725.JP&back=ACWI
POOL	POOL CORP	/etf/ea/ETZCW.djhtm?c=1&etfid=POOL.US&back=ACWI
RPRX	ROYALTY PHARMA PLC CLASS A	/etf/ea/ETZCW.djhtm?c=1&etfid=RPRX.US&back=ACWI
601668.SH&back=ACWI	CHINA STATE CONSTRUCTION ENGINEERI	/etf/ea/ETZCW.djhtm?c=1&etfid=601668.SH&back=ACWI
RBLX	ROBLOX CORP CLASS A	/etf/ea/ETZCW.djhtm?c=1&etfid=RBLX.US&back=ACWI
	ATLAS COPCO CLASS B	
	CAMECO CORP	
CPT	CAMDEN PROPERTY TRUST REIT	/etf/ea/ETZCW.djhtm?c=1&etfid=CPT.US&back=ACWI
LVS	LAS VEGAS SANDS CORP	/etf/ea/ETZCW.djhtm?c=1&etfid=LVS.US&back=ACWI
BXP	BOSTON PROPERTIES REIT INC	/etf/ea/ETZCW.djhtm?c=1&etfid=BXP.US&back=ACWI
	NATWEST GROUP PLC	
CINF	CINCINNATI FINANCIAL CORP	/etf/ea/ETZCW.djhtm?c=1&etfid=CINF.US&back=ACWI
HZNP	HORIZON THERAPEUTICS PUBLIC PLC	/etf/ea/ETZCW.djhtm?c=1&etfid=HZNP.US&back=ACWI
	TELEPERFORMANCE	
	BT GROUP PLC	
MGM	MGM RESORTS INTERNATIONAL	/etf/ea/ETZCW.djhtm?c=1&etfid=MGM.US&back=ACWI
WPC	W. P. CAREY REIT INC	/etf/ea/ETZCW.djhtm?c=1&etfid=WPC.US&back=ACWI
VFC	VF CORP	/etf/ea/ETZCW.djhtm?c=1&etfid=VFC.US&back=ACWI
	PUBLIC BANK	
KIM	KIMCO REALTY REIT CORP	/etf/ea/ETZCW.djhtm?c=1&etfid=KIM.US&back=ACWI
SSNC	SS AND C TECHNOLOGIES HOLDINGS INC	/etf/ea/ETZCW.djhtm?c=1&etfid=SSNC.US&back=ACWI
PINS	PINTEREST INC CLASS A	/etf/ea/ETZCW.djhtm?c=1&etfid=PINS.US&back=ACWI
CE	CELANESE CORP	/etf/ea/ETZCW.djhtm?c=1&etfid=CE.US&back=ACWI
7269.JP&back=ACWI	SUZUKI MOTOR CORP	/etf/ea/ETZCW.djhtm?c=1&etfid=7269.JP&back=ACWI
4578.JP&back=ACWI	OTSUKA HOLDINGS LTD	/etf/ea/ETZCW.djhtm?c=1&etfid=4578.JP&back=ACWI
	SABIC AGRI-NUTRIENTS	
	CITRIX SYSTEMS INC	
	ARCELORMITTAL SA	
	ABU DHABI COMMERCIAL BANK	
	CAIXABANK SA	
	SARTORIUS PREF AG	
4507.JP&back=ACWI	SHIONOGI LTD	/etf/ea/ETZCW.djhtm?c=1&etfid=4507.JP&back=ACWI
2802.JP&back=ACWI	AJINOMOTO INC	/etf/ea/ETZCW.djhtm?c=1&etfid=2802.JP&back=ACWI
	NOVOZYMES B	
	GETLINK	
	ASM INTERNATIONAL NV	
	GROUPE BRUXELLES LAMBERT NV	
FICO	FAIR ISAAC CORP	/etf/ea/ETZCW.djhtm?c=1&etfid=FICO.US&back=ACWI
	TITAN COMPANY LTD	
	SHAW COMMUNICATIONS INC CLASS B	
ABMD	ABIOMED INC	/etf/ea/ETZCW.djhtm?c=1&etfid=ABMD.US&back=ACWI
207940.KS&back=ACWI	SAMSUNG BIOLOGICS LTD	/etf/ea/ETZCW.djhtm?c=1&etfid=207940.KS&back=ACWI
	BANGKOK DUSIT MEDICAL SERVICES NON	
2388.HK&back=ACWI	BOC HONG KONG HOLDINGS LTD	/etf/ea/ETZCW.djhtm?c=1&etfid=2388.HK&back=ACWI
1301.TW&back=ACWI	FORMOSA PLASTICS CORP	/etf/ea/ETZCW.djhtm?c=1&etfid=1301.TW&back=ACWI
1088.HK&back=ACWI	CHINA SHENHUA ENERGY LTD H	/etf/ea/ETZCW.djhtm?c=1&etfid=1088.HK&back=ACWI
ENTG	ENTEGRIS INC	/etf/ea/ETZCW.djhtm?c=1&etfid=ENTG.US&back=ACWI
	BOUBYAN BANK	
FOXA	FOX CORP CLASS A	/etf/ea/ETZCW.djhtm?c=1&etfid=FOXA.US&back=ACWI
WTRG	ESSENTIAL UTILITIES INC	/etf/ea/ETZCW.djhtm?c=1&etfid=WTRG.US&back=ACWI
Y	ALLEGHANYCORP	/etf/ea/ETZCW.djhtm?c=1&etfid=Y.US&back=ACWI
PLTR	PALANTIR TECHNOLOGIES INC CLASS A	/etf/ea/ETZCW.djhtm?c=1&etfid=PLTR.US&back=ACWI
0003.HK&back=ACWI	HONG KONG AND CHINA GAS LTD	/etf/ea/ETZCW.djhtm?c=1&etfid=0003.HK&back=ACWI
1605.JP&back=ACWI	INPEX CORP	/etf/ea/ETZCW.djhtm?c=1&etfid=1605.JP&back=ACWI
NDSN	NORDSON CORP	/etf/ea/ETZCW.djhtm?c=1&etfid=NDSN.US&back=ACWI
	STANDARD BANK GROUP	
2886.TW&back=ACWI	MEGA FINANCIAL HOLDING LTD	/etf/ea/ETZCW.djhtm?c=1&etfid=2886.TW&back=ACWI
RE	EVEREST RE GROUP LTD	/etf/ea/ETZCW.djhtm?c=1&etfid=RE.US&back=ACWI
	ATLANTIA	
601318.SH&back=ACWI	PING AN INSURANCE (GROUP) OF CHINA	/etf/ea/ETZCW.djhtm?c=1&etfid=601318.SH&back=ACWI
	BANQUE SAUDI FRANSI	
EVRG	EVERGY INC	/etf/ea/ETZCW.djhtm?c=1&etfid=EVRG.US&back=ACWI
CNP	CENTERPOINT ENERGY INC	/etf/ea/ETZCW.djhtm?c=1&etfid=CNP.US&back=ACWI
	NN GROUP NV	
	SWISS LIFE HOLDING AG	
SWK	STANLEY BLACK & DECKER INC	/etf/ea/ETZCW.djhtm?c=1&etfid=SWK.US&back=ACWI
0386.HK&back=ACWI	CHINA PETROLEUM AND CHEMICAL CORP	/etf/ea/ETZCW.djhtm?c=1&etfid=0386.HK&back=ACWI
600036.SH&back=ACWI	CHINA MERCHANTS BANK LTD A	/etf/ea/ETZCW.djhtm?c=1&etfid=600036.SH&back=ACWI
0175.HK&back=ACWI	GEELY AUTOMOBILE HOLDINGS LTD	/etf/ea/ETZCW.djhtm?c=1&etfid=0175.HK&back=ACWI
HBAN	HUNTINGTON BANCSHARES INC	/etf/ea/ETZCW.djhtm?c=1&etfid=HBAN.US&back=ACWI
	SASOL LTD	
	HENKEL & KGAA PREF AG	
9101.JP&back=ACWI	NIPPON YUSEN	/etf/ea/ETZCW.djhtm?c=1&etfid=9101.JP&back=ACWI
9735.JP&back=ACWI	SECOM LTD	/etf/ea/ETZCW.djhtm?c=1&etfid=9735.JP&back=ACWI
5020.JP&back=ACWI	ENEOS HOLDINGS INC	/etf/ea/ETZCW.djhtm?c=1&etfid=5020.JP&back=ACWI
600900.SH&back=ACWI	CHINA YANGTZE POWER LTD A	/etf/ea/ETZCW.djhtm?c=1&etfid=600900.SH&back=ACWI
8267.JP&back=ACWI	AEON LTD	/etf/ea/ETZCW.djhtm?c=1&etfid=8267.JP&back=ACWI
	LOBLAW COMPANIES LTD	
EQH	EQUITABLE HOLDINGS INC	/etf/ea/ETZCW.djhtm?c=1&etfid=EQH.US&back=ACWI
	ASX LTD	
BIO	BIO RAD LABORATORIES INC CLASS A	/etf/ea/ETZCW.djhtm?c=1&etfid=BIO.US&back=ACWI
	SAUDI ELECTRICITY	
TECH	BIO TECHNE CORP	/etf/ea/ETZCW.djhtm?c=1&etfid=TECH.US&back=ACWI
VTRS	VIATRIS INC	/etf/ea/ETZCW.djhtm?c=1&etfid=VTRS.US&back=ACWI
	ASTRA INTERNATIONAL	
APA	APA CORP	/etf/ea/ETZCW.djhtm?c=1&etfid=APA.US&back=ACWI
ZI	ZOOMINFO TECHNOLOGIES INC	/etf/ea/ETZCW.djhtm?c=1&etfid=ZI.US&back=ACWI
	TELSTRA CORPORATION LTD	
7309.JP&back=ACWI	SHIMANO INC	/etf/ea/ETZCW.djhtm?c=1&etfid=7309.JP&back=ACWI
SNAP	SNAP INC CLASS A	/etf/ea/ETZCW.djhtm?c=1&etfid=SNAP.US&back=ACWI
	CAPITALAND INTEGRATED COMMERCIAL T	
JKHY	JACK HENRY AND ASSOCIATES INC	/etf/ea/ETZCW.djhtm?c=1&etfid=JKHY.US&back=ACWI
TWLO	TWILIO INC CLASS A	/etf/ea/ETZCW.djhtm?c=1&etfid=TWLO.US&back=ACWI
	KRW CASH	
0011.HK&back=ACWI	HANG SENG BANK LTD	/etf/ea/ETZCW.djhtm?c=1&etfid=0011.HK&back=ACWI
	SWEDBANK	
BEKE	KE HOLDINGS ADR REPRESENTINGINC	/etf/ea/ETZCW.djhtm?c=1&etfid=BEKE.US&back=ACWI
AAP	ADVANCE AUTO PARTS INC	/etf/ea/ETZCW.djhtm?c=1&etfid=AAP.US&back=ACWI
CHKP	CHECK POINT SOFTWARE TECHNOLOGIES	/etf/ea/ETZCW.djhtm?c=1&etfid=CHKP.US&back=ACWI
	ADANI ENTERPRISES LTD	
	KONINKLIJKE KPN NV	
	CREDIT SUISSE GROUP AG	
	COLOPLAST B	
	PORSCHE AUTOMOBIL HOLDING PREF	
JBHT	JB HUNT TRANSPORT SERVICES INC	/etf/ea/ETZCW.djhtm?c=1&etfid=JBHT.US&back=ACWI
	AVIVA PLC	
7011.JP&back=ACWI	MITSUBISHI HEAVY INDUSTRIES LTD	/etf/ea/ETZCW.djhtm?c=1&etfid=7011.JP&back=ACWI
DOCU	DOCUSIGN INC	/etf/ea/ETZCW.djhtm?c=1&etfid=DOCU.US&back=ACWI
8604.JP&back=ACWI	NOMURA HOLDINGS INC	/etf/ea/ETZCW.djhtm?c=1&etfid=8604.JP&back=ACWI
	SYMRISE AG	
	SGS SA	
	DAIMLER TRUCK HOLDING E AG	
WRK	WESTROCK	/etf/ea/ETZCW.djhtm?c=1&etfid=WRK.US&back=ACWI
	KEPPEL LTD	
6723.JP&back=ACWI	RENESAS ELECTRONICS CORP	/etf/ea/ETZCW.djhtm?c=1&etfid=6723.JP&back=ACWI
	SMURFIT KAPPA GROUP PLC	
	FIRST QUANTUM MINERALS LTD	
	KBC GROEP	
AVY	AVERY DENNISON CORP	/etf/ea/ETZCW.djhtm?c=1&etfid=AVY.US&back=ACWI
GRMN	GARMIN LTD	/etf/ea/ETZCW.djhtm?c=1&etfid=GRMN.US&back=ACWI
	SNAM	
1109.HK&back=ACWI	CHINA RESOURCES LAND LTD	/etf/ea/ETZCW.djhtm?c=1&etfid=1109.HK&back=ACWI
	WPP PLC	
	AKER BP	
	SUN PHARMACEUTICAL INDUSTRIES LTD	
1216.TW&back=ACWI	UNI-PRESIDENT ENTERPRISES CORP	/etf/ea/ETZCW.djhtm?c=1&etfid=1216.TW&back=ACWI
300750.SZ&back=ACWI	CONTEMPORARY AMPEREX TECHNOLOGY LT	/etf/ea/ETZCW.djhtm?c=1&etfid=300750.SZ&back=ACWI
2688.HK&back=ACWI	ENN ENERGY HOLDINGS LTD	/etf/ea/ETZCW.djhtm?c=1&etfid=2688.HK&back=ACWI
1925.JP&back=ACWI	DAIWA HOUSE INDUSTRY LTD	/etf/ea/ETZCW.djhtm?c=1&etfid=1925.JP&back=ACWI
	OPEN TEXT CORP	
8630.JP&back=ACWI	SOMPO HOLDINGS INC	/etf/ea/ETZCW.djhtm?c=1&etfid=8630.JP&back=ACWI
PTC	PTC INC	/etf/ea/ETZCW.djhtm?c=1&etfid=PTC.US&back=ACWI
	SCENTRE GROUP	
	BANK LEUMI LE ISRAEL	
	CAPITEC LTD	
FNF	FIDELITY NATIONAL FINANCIAL INC	/etf/ea/ETZCW.djhtm?c=1&etfid=FNF.US&back=ACWI
COO	COOPER INC	/etf/ea/ETZCW.djhtm?c=1&etfid=COO.US&back=ACWI
012330.KS&back=ACWI	HYUNDAI MOBIS LTD	/etf/ea/ETZCW.djhtm?c=1&etfid=012330.KS&back=ACWI
NVR	NVR INC	/etf/ea/ETZCW.djhtm?c=1&etfid=NVR.US&back=ACWI
	SMITH AND NEPHEW PLC	
086790.KS&back=ACWI	HANA FINANCIAL GROUP INC	/etf/ea/ETZCW.djhtm?c=1&etfid=086790.KS&back=ACWI
TRGP	TARGA RESOURCES CORP	/etf/ea/ETZCW.djhtm?c=1&etfid=TRGP.US&back=ACWI
	SEVERN TRENT PLC	
055550.KS&back=ACWI	SHINHAN FINANCIAL GROUP LTD	/etf/ea/ETZCW.djhtm?c=1&etfid=055550.KS&back=ACWI
ZTO	ZTO EXPRESS CAYMAN ADR REPRESENTIN	/etf/ea/ETZCW.djhtm?c=1&etfid=ZTO.US&back=ACWI
	CARREFOUR SA	
CCEP	COCA COLA EUROPACIFIC PARTNERS PLC	/etf/ea/ETZCW.djhtm?c=1&etfid=CCEP.US&back=ACWI
0027.HK&back=ACWI	GALAXY ENTERTAINMENT GROUP LTD	/etf/ea/ETZCW.djhtm?c=1&etfid=0027.HK&back=ACWI
	ADANI GREEN ENERGY LTD	
600030.SH&back=ACWI	CITIC SECURITIES LTD A	/etf/ea/ETZCW.djhtm?c=1&etfid=600030.SH&back=ACWI
NRG	NRG ENERGY INC	/etf/ea/ETZCW.djhtm?c=1&etfid=NRG.US&back=ACWI
	CCL INDUSTRIES INC CLASS B	
	WORLDLINE SA	
	TATA STEEL LTD	
	SEGRO REIT PLC	
	SM PRIME HOLDINGS INC	
	TATA MOTORS LTD	
	ASCENDAS REAL ESTATE INVESTMENT TR	
PHM	PULTEGROUP INC	/etf/ea/ETZCW.djhtm?c=1&etfid=PHM.US&back=ACWI
	THALES SA	
HAS	HASBRO INC	/etf/ea/ETZCW.djhtm?c=1&etfid=HAS.US&back=ACWI
DASH	DOORDASH INC CLASS A	/etf/ea/ETZCW.djhtm?c=1&etfid=DASH.US&back=ACWI
RPM	RPM INTERNATIONAL INC	/etf/ea/ETZCW.djhtm?c=1&etfid=RPM.US&back=ACWI
2628.HK&back=ACWI	CHINA LIFE INSURANCE LTD H	/etf/ea/ETZCW.djhtm?c=1&etfid=2628.HK&back=ACWI
	ST JAMESS PLACE PLC	
	CREDIT AGRICOLE SA	
	STRAUMANN HOLDING AG	
9633.HK&back=ACWI	NONGFU SPRING LTD H	/etf/ea/ETZCW.djhtm?c=1&etfid=9633.HK&back=ACWI
TAP	MOLSON COORS BREWINGCLASS B	/etf/ea/ETZCW.djhtm?c=1&etfid=TAP.US&back=ACWI
QRVO	QORVO INC	/etf/ea/ETZCW.djhtm?c=1&etfid=QRVO.US&back=ACWI
TEVA	TEVA PHARMACEUTICAL INDUSTRIES ADR	/etf/ea/ETZCW.djhtm?c=1&etfid=TEVA.US&back=ACWI
	BOLIDEN	
WHR	WHIRLPOOL CORP	/etf/ea/ETZCW.djhtm?c=1&etfid=WHR.US&back=ACWI
7270.JP&back=ACWI	SUBARU CORP	/etf/ea/ETZCW.djhtm?c=1&etfid=7270.JP&back=ACWI
	BANK MANDIRI (PERSERO)	
6920.JP&back=ACWI	LASERTEC CORP	/etf/ea/ETZCW.djhtm?c=1&etfid=6920.JP&back=ACWI
8309.JP&back=ACWI	SUMITOMO MITSUI TRUST HOLDINGS INC	/etf/ea/ETZCW.djhtm?c=1&etfid=8309.JP&back=ACWI
	SIEMENS HEALTHINEERS AG	
0291.HK&back=ACWI	CHINA RESOURCES BEER HOLDINGS LTD	/etf/ea/ETZCW.djhtm?c=1&etfid=0291.HK&back=ACWI
	MTU AERO ENGINES HOLDING AG	
5880.TW&back=ACWI	TAIWAN COOPERATIVE FINANCIAL HOLDI	/etf/ea/ETZCW.djhtm?c=1&etfid=5880.TW&back=ACWI
	FRESENIUS SE AND CO KGAA	
PKG	PACKAGING CORP OF AMERICA	/etf/ea/ETZCW.djhtm?c=1&etfid=PKG.US&back=ACWI
2002.TW&back=ACWI	CHINA STEEL CORP	/etf/ea/ETZCW.djhtm?c=1&etfid=2002.TW&back=ACWI
3407.JP&back=ACWI	ASAHI KASEI CORP	/etf/ea/ETZCW.djhtm?c=1&etfid=3407.JP&back=ACWI
	SANLAM LIMITED LTD	
	NEWCREST MINING LTD	
0688.HK&back=ACWI	CHINA OVERSEAS LAND INVESTMENT LTD	/etf/ea/ETZCW.djhtm?c=1&etfid=0688.HK&back=ACWI
2382.HK&back=ACWI	SUNNY OPTICAL TECHNOLOGY LTD	/etf/ea/ETZCW.djhtm?c=1&etfid=2382.HK&back=ACWI
AFG	AMERICAN FINANCIAL GROUP INC	/etf/ea/ETZCW.djhtm?c=1&etfid=AFG.US&back=ACWI
SBNY	SIGNATURE BANK	/etf/ea/ETZCW.djhtm?c=1&etfid=SBNY.US&back=ACWI
	CEZ	
FFIV	F5 INC	/etf/ea/ETZCW.djhtm?c=1&etfid=FFIV.US&back=ACWI
	CANADIAN UTILITIES LTD CLASS A	
6857.JP&back=ACWI	ADVANTEST CORP	/etf/ea/ETZCW.djhtm?c=1&etfid=6857.JP&back=ACWI
	CP ALL NON-VOTING DR PCL	
	JARDINE MATHESON HOLDINGS LTD	
	WSP GLOBAL INC	
	JAMES HARDIE INDUSTRIES CDI PLC	
	KONE	
600000.SH&back=ACWI	SHANGHAI PUDONG DEVELOPMENT BANK L	/etf/ea/ETZCW.djhtm?c=1&etfid=600000.SH&back=ACWI
	ROCHE HOLDING AG	
	RENTOKIL INITIAL PLC	
	BAJAJ FINSERV LTD	
	NEXT PLC	
	CENTRAIS ELETR BRAS-ELETROBRAS	
RIVN	RIVIAN AUTOMOTIVE INC CLASS A	/etf/ea/ETZCW.djhtm?c=1&etfid=RIVN.US&back=ACWI
	MIZRAHI TEFAHOT BANK LTD	
3711.TW&back=ACWI	ASE TECHNOLOGY HOLDING LTD	/etf/ea/ETZCW.djhtm?c=1&etfid=3711.TW&back=ACWI
MTN	VAIL RESORTS INC	/etf/ea/ETZCW.djhtm?c=1&etfid=MTN.US&back=ACWI
BURL	BURLINGTON STORES INC	/etf/ea/ETZCW.djhtm?c=1&etfid=BURL.US&back=ACWI
	EMAAR PROPERTIES	
DELL	DELL TECHNOLOGIES INC CLASS C	/etf/ea/ETZCW.djhtm?c=1&etfid=DELL.US&back=ACWI
	ICL GROUP LTD	
0857.HK&back=ACWI	PETROCHINA LTD H	/etf/ea/ETZCW.djhtm?c=1&etfid=0857.HK&back=ACWI
	STORA ENSO CLASS R	
NBIX	NEUROCRINE BIOSCIENCES INC	/etf/ea/ETZCW.djhtm?c=1&etfid=NBIX.US&back=ACWI
BBWI	BATH AND BODY WORKS INC	/etf/ea/ETZCW.djhtm?c=1&etfid=BBWI.US&back=ACWI
	SAPUTO INC	
6869.JP&back=ACWI	SYSMEX CORP	/etf/ea/ETZCW.djhtm?c=1&etfid=6869.JP&back=ACWI
	TELIA COMPANY	
	APA GROUP UNITS	
3659.JP&back=ACWI	NEXON LTD	/etf/ea/ETZCW.djhtm?c=1&etfid=3659.JP&back=ACWI
JNPR	JUNIPER NETWORKS INC	/etf/ea/ETZCW.djhtm?c=1&etfid=JNPR.US&back=ACWI
4523.JP&back=ACWI	EISAI LTD	/etf/ea/ETZCW.djhtm?c=1&etfid=4523.JP&back=ACWI
JAZZ	JAZZ PHARMACEUTICALS PLC	/etf/ea/ETZCW.djhtm?c=1&etfid=JAZZ.US&back=ACWI
	METRO INC	
601328.SH&back=ACWI	BANK OF COMMUNICATIONS LTD A	/etf/ea/ETZCW.djhtm?c=1&etfid=601328.SH&back=ACWI
CRL	CHARLES RIVER LABORATORIES INTERNA	/etf/ea/ETZCW.djhtm?c=1&etfid=CRL.US&back=ACWI
BWA	BORGWARNER INC	/etf/ea/ETZCW.djhtm?c=1&etfid=BWA.US&back=ACWI
	THE SWATCH GROUP AG	
BKI	BLACK KNIGHT INC	/etf/ea/ETZCW.djhtm?c=1&etfid=BKI.US&back=ACWI
ALLY	ALLY FINANCIAL INC	/etf/ea/ETZCW.djhtm?c=1&etfid=ALLY.US&back=ACWI
LUMN	LUMEN TECHNOLOGIES INC	/etf/ea/ETZCW.djhtm?c=1&etfid=LUMN.US&back=ACWI
	TECH MAHINDRA LTD	
	MOBILE TEL	
CSL	CARLISLE COMPANIES INC	/etf/ea/ETZCW.djhtm?c=1&etfid=CSL.US&back=ACWI
CCK	CROWN HOLDINGS INC	/etf/ea/ETZCW.djhtm?c=1&etfid=CCK.US&back=ACWI
	BUNZL	
	BEIERSDORF AG	
	BCE INC	
	AVENUE SUPERMARTS LTD	
	TRYG	
SNA	SNAP ON INC	/etf/ea/ETZCW.djhtm?c=1&etfid=SNA.US&back=ACWI
HII	HUNTINGTON INGALLS INDUSTRIES INC	/etf/ea/ETZCW.djhtm?c=1&etfid=HII.US&back=ACWI
CZR	CAESARS ENTERTAINMENT INC	/etf/ea/ETZCW.djhtm?c=1&etfid=CZR.US&back=ACWI
	SUNCORP GROUP LTD	
ELS	EQUITY LIFESTYLE PROPERTIES REIT I	/etf/ea/ETZCW.djhtm?c=1&etfid=ELS.US&back=ACWI
	BID CORPORATION LTD	
1093.HK&back=ACWI	CSPC PHARMACEUTICAL GROUP LTD	/etf/ea/ETZCW.djhtm?c=1&etfid=1093.HK&back=ACWI
	BURBERRY GROUP PLC	
4684.JP&back=ACWI	OBIC LTD	/etf/ea/ETZCW.djhtm?c=1&etfid=4684.JP&back=ACWI
	YARA INTERNATIONAL	
	SVENSKA HANDELSBANKEN-A SHS	
VST	VISTRA CORP	/etf/ea/ETZCW.djhtm?c=1&etfid=VST.US&back=ACWI
	IMPALA PLATINUM LTD	
LNC	LINCOLN NATIONAL CORP	/etf/ea/ETZCW.djhtm?c=1&etfid=LNC.US&back=ACWI
	EMIRATES NBD	
	PTT NON-VOTING DR PCL	
5871.TW&back=ACWI	CHAILEASE HOLDING LTD	/etf/ea/ETZCW.djhtm?c=1&etfid=5871.TW&back=ACWI
	ENTAIN PLC	
2892.TW&back=ACWI	FIRST FINANCIAL HOLDING LTD	/etf/ea/ETZCW.djhtm?c=1&etfid=2892.TW&back=ACWI
028260.KS&back=ACWI	SAMSUNG C&T CORP	/etf/ea/ETZCW.djhtm?c=1&etfid=028260.KS&back=ACWI
	AEGON NV	
	XERO LTD	
	DANSKE BANK	
RCL	ROYAL CARIBBEAN GROUP LTD	/etf/ea/ETZCW.djhtm?c=1&etfid=RCL.US&back=ACWI
	SWISS PRIME SITE AG	
	UCB SA	
4528.JP&back=ACWI	ONO PHARMACEUTICAL LTD	/etf/ea/ETZCW.djhtm?c=1&etfid=4528.JP&back=ACWI
	ULTRATECH CEMENT LTD	
	BANK HAPOALIM BM	
066570.KS&back=ACWI	LG ELECTRONICS INC	/etf/ea/ETZCW.djhtm?c=1&etfid=066570.KS&back=ACWI
BGNE	BEIGENE ADS REPRESENTING LTD	/etf/ea/ETZCW.djhtm?c=1&etfid=BGNE.US&back=ACWI
7201.JP&back=ACWI	NISSAN MOTOR LTD	/etf/ea/ETZCW.djhtm?c=1&etfid=7201.JP&back=ACWI
002594.SZ&back=ACWI	BYD LTD A	/etf/ea/ETZCW.djhtm?c=1&etfid=002594.SZ&back=ACWI
2801.JP&back=ACWI	KIKKOMAN CORP	/etf/ea/ETZCW.djhtm?c=1&etfid=2801.JP&back=ACWI
9104.JP&back=ACWI	MITSUI OSK LINES LTD	/etf/ea/ETZCW.djhtm?c=1&etfid=9104.JP&back=ACWI
2887.TW&back=ACWI	TAISHIN FINANCIAL HOLDING LTD	/etf/ea/ETZCW.djhtm?c=1&etfid=2887.TW&back=ACWI
6690.HK&back=ACWI	HAIER SMART HOME CLASS H LTD H	/etf/ea/ETZCW.djhtm?c=1&etfid=6690.HK&back=ACWI
	WEG SA	
	ALDAR PROPERTIES	
ZEN	ZENDESK INC	/etf/ea/ETZCW.djhtm?c=1&etfid=ZEN.US&back=ACWI
TPL	TEXAS PACIFIC LAND CORP	/etf/ea/ETZCW.djhtm?c=1&etfid=TPL.US&back=ACWI
0006.HK&back=ACWI	POWER ASSETS HOLDINGS LTD	/etf/ea/ETZCW.djhtm?c=1&etfid=0006.HK&back=ACWI
1928.JP&back=ACWI	SEKISUI HOUSE LTD	/etf/ea/ETZCW.djhtm?c=1&etfid=1928.JP&back=ACWI
601398.SH&back=ACWI	INDUSTRIAL AND COMMERCIAL BANK OF	/etf/ea/ETZCW.djhtm?c=1&etfid=601398.SH&back=ACWI
	AUCKLAND INTERNATIONAL AIRPORT LTD	
4307.JP&back=ACWI	NOMURA RESEARCH INSTITUTE LTD	/etf/ea/ETZCW.djhtm?c=1&etfid=4307.JP&back=ACWI
	ITAUSA INVESTIMENTOS ITAU PREF SA	
AA	ALCOA CORP	/etf/ea/ETZCW.djhtm?c=1&etfid=AA.US&back=ACWI
1801.JP&back=ACWI	TAISEI CORP	/etf/ea/ETZCW.djhtm?c=1&etfid=1801.JP&back=ACWI
CLF	CLEVELAND CLIFFS INC	/etf/ea/ETZCW.djhtm?c=1&etfid=CLF.US&back=ACWI
	MEDIBANK PRIVATE LTD	
	SARTORIUS STEDIM BIOTECH SA	
	TELENOR	
	AIRPORTS OF THAILAND NON-VOTING DR	
FCNCA	FIRST CITIZENS BANCSHARES INC CLAS	/etf/ea/ETZCW.djhtm?c=1&etfid=FCNCA.US&back=ACWI
	ORIGIN ENERGY LTD	
PNR	PENTAIR	/etf/ea/ETZCW.djhtm?c=1&etfid=PNR.US&back=ACWI
EMN	EASTMAN CHEMICAL	/etf/ea/ETZCW.djhtm?c=1&etfid=EMN.US&back=ACWI
	SVENSKA CELLULOSA B	
5802.JP&back=ACWI	SUMITOMO ELECTRIC INDUSTRIES LTD	/etf/ea/ETZCW.djhtm?c=1&etfid=5802.JP&back=ACWI
	LOGITECH INTERNATIONAL SA	
L	LOEWS CORP	/etf/ea/ETZCW.djhtm?c=1&etfid=L.US&back=ACWI
HTHT	H WORLD GROUP ADR LTD	/etf/ea/ETZCW.djhtm?c=1&etfid=HTHT.US&back=ACWI
	GOLD FIELDS LTD	
MKTX	MARKETAXESS HOLDINGS INC	/etf/ea/ETZCW.djhtm?c=1&etfid=MKTX.US&back=ACWI
	INTERTEK GROUP PLC	
	DAVIDE CAMPARI MILANO NV	
GL	GLOBE LIFE INC	/etf/ea/ETZCW.djhtm?c=1&etfid=GL.US&back=ACWI
AVLR	AVALARA INC	/etf/ea/ETZCW.djhtm?c=1&etfid=AVLR.US&back=ACWI
3402.JP&back=ACWI	TORAY INDUSTRIES INC	/etf/ea/ETZCW.djhtm?c=1&etfid=3402.JP&back=ACWI
BAP	CREDICORP LTD	/etf/ea/ETZCW.djhtm?c=1&etfid=BAP.US&back=ACWI
	ARC RESOURCES LTD	
	NTPC LTD	
	SONIC HEALTHCARE LTD	
	COMPUTERSHARE	
CCL	CARNIVAL CORP	/etf/ea/ETZCW.djhtm?c=1&etfid=CCL.US&back=ACWI
9613.JP&back=ACWI	NTT DATA CORP	/etf/ea/ETZCW.djhtm?c=1&etfid=9613.JP&back=ACWI
WBS	WEBSTER FINANCIAL CORP	/etf/ea/ETZCW.djhtm?c=1&etfid=WBS.US&back=ACWI
	HINDALCO INDUSTRIES LTD	
8951.JP&back=ACWI	NIPPON BUILDING FUND REIT INC	/etf/ea/ETZCW.djhtm?c=1&etfid=8951.JP&back=ACWI
	QIAGEN NV	
	BDO UNIBANK INC	
2890.TW&back=ACWI	SINOPAC FINANCIAL HOLDINGS LTD	/etf/ea/ETZCW.djhtm?c=1&etfid=2890.TW&back=ACWI
	SBI LIFE INSURANCE COMPANY LTD	
DT	DYNATRACE INC	/etf/ea/ETZCW.djhtm?c=1&etfid=DT.US&back=ACWI
	RAMSAY HEALTH CARE LTD	
6645.JP&back=ACWI	OMRON CORP	/etf/ea/ETZCW.djhtm?c=1&etfid=6645.JP&back=ACWI
BEN	FRANKLIN RESOURCES INC	/etf/ea/ETZCW.djhtm?c=1&etfid=BEN.US&back=ACWI
	PEARSON PLC	
CPB	CAMPBELL SOUP	/etf/ea/ETZCW.djhtm?c=1&etfid=CPB.US&back=ACWI
000858.SZ&back=ACWI	WULIANGYE YIBIN LTD A	/etf/ea/ETZCW.djhtm?c=1&etfid=000858.SZ&back=ACWI
CDAY	CERIDIAN HCM HOLDING INC	/etf/ea/ETZCW.djhtm?c=1&etfid=CDAY.US&back=ACWI
4704.JP&back=ACWI	TREND MICRO INC	/etf/ea/ETZCW.djhtm?c=1&etfid=4704.JP&back=ACWI
8069.TW&back=ACWI	E INK HOLDINGS INC	/etf/ea/ETZCW.djhtm?c=1&etfid=8069.TW&back=ACWI
	AUTO TRADER GROUP PLC	
XPEV	XPENG ADR REPRESENTINGINC	/etf/ea/ETZCW.djhtm?c=1&etfid=XPEV.US&back=ACWI
	JSW STEEL LTD	
TFX	TELEFLEX INC	/etf/ea/ETZCW.djhtm?c=1&etfid=TFX.US&back=ACWI
9962.JP&back=ACWI	MISUMI GROUP INC	/etf/ea/ETZCW.djhtm?c=1&etfid=9962.JP&back=ACWI
8308.JP&back=ACWI	RESONA HOLDINGS INC	/etf/ea/ETZCW.djhtm?c=1&etfid=8308.JP&back=ACWI
NWL	NEWELL BRANDS INC	/etf/ea/ETZCW.djhtm?c=1&etfid=NWL.US&back=ACWI
096770.KS&back=ACWI	SK INNOVATION LTD	/etf/ea/ETZCW.djhtm?c=1&etfid=096770.KS&back=ACWI
	TFI INTERNATIONAL INC	
	TENARIS SA	
	FISHER AND PAYKEL HEALTHCARE CORPO	
300498.SZ&back=ACWI	WENS FOODSTUFF GROUP LTD	/etf/ea/ETZCW.djhtm?c=1&etfid=300498.SZ&back=ACWI
	AUD CASH	
601229.SH&back=ACWI	BANK OF SHANGHAI LTD A	/etf/ea/ETZCW.djhtm?c=1&etfid=601229.SH&back=ACWI
ROKU	ROKU INC CLASS A	/etf/ea/ETZCW.djhtm?c=1&etfid=ROKU.US&back=ACWI
	CRODA INTERNATIONAL PLC	
RHI	ROBERT HALF	/etf/ea/ETZCW.djhtm?c=1&etfid=RHI.US&back=ACWI
	BOUYGUES SA	
	HENNES & MAURITZ	
601288.SH&back=ACWI	AGRICULTURAL BANK OF CHINA LTD A	/etf/ea/ETZCW.djhtm?c=1&etfid=601288.SH&back=ACWI
2267.JP&back=ACWI	YAKULT HONSHA LTD	/etf/ea/ETZCW.djhtm?c=1&etfid=2267.JP&back=ACWI
HSIC	HENRY SCHEIN INC	/etf/ea/ETZCW.djhtm?c=1&etfid=HSIC.US&back=ACWI
	OMV AG	
	NESTLE INDIA LTD	
	COCHLEAR LTD	
	CIMB GROUP HOLDINGS	
1802.JP&back=ACWI	OBAYASHI CORP	/etf/ea/ETZCW.djhtm?c=1&etfid=1802.JP&back=ACWI
6988.JP&back=ACWI	NITTO DENKO CORP	/etf/ea/ETZCW.djhtm?c=1&etfid=6988.JP&back=ACWI
1812.JP&back=ACWI	KAJIMA CORP	/etf/ea/ETZCW.djhtm?c=1&etfid=1812.JP&back=ACWI
2801.TW&back=ACWI	CHANG HWA COMMERCIAL BANK LTD	/etf/ea/ETZCW.djhtm?c=1&etfid=2801.TW&back=ACWI
	CANADIAN TIRE LTD CLASS A	
	RITCHIE BROS AUCTIONEERS INC	
NLY	ANNALY CAPITAL MANAGEMENT REIT INC	/etf/ea/ETZCW.djhtm?c=1&etfid=NLY.US&back=ACWI
XRAY	DENTSPLY SIRONA INC	/etf/ea/ETZCW.djhtm?c=1&etfid=XRAY.US&back=ACWI
2313.HK&back=ACWI	SHENZHOU INTERNATIONAL GROUP LTD	/etf/ea/ETZCW.djhtm?c=1&etfid=2313.HK&back=ACWI
033780.KS&back=ACWI	KT&G CORP	/etf/ea/ETZCW.djhtm?c=1&etfid=033780.KS&back=ACWI
U	UNITY SOFTWARE INC	/etf/ea/ETZCW.djhtm?c=1&etfid=U.US&back=ACWI
1326.TW&back=ACWI	FORMOSA CHEMICALS & FIBRE CORP	/etf/ea/ETZCW.djhtm?c=1&etfid=1326.TW&back=ACWI
ALLE	ALLEGION PLC	/etf/ea/ETZCW.djhtm?c=1&etfid=ALLE.US&back=ACWI
	NORSK HYDRO	
	DEXUS STAPLED UNITS	
6701.JP&back=ACWI	NEC CORP	/etf/ea/ETZCW.djhtm?c=1&etfid=6701.JP&back=ACWI
	SPIRAX-SARCO ENGINEERING PLC	
	AGEAS SA	
6618.HK&back=ACWI	JD HEALTH INTERNATIONAL INC	/etf/ea/ETZCW.djhtm?c=1&etfid=6618.HK&back=ACWI
	NORTHLAND POWER INC	
IPG	INTERPUBLIC GROUP OF COMPANIES INC	/etf/ea/ETZCW.djhtm?c=1&etfid=IPG.US&back=ACWI
	RECORDATI INDUSTRIA CHIMICA E FARM	
MPW	MEDICAL PROPERTIES TRUST REIT INC	/etf/ea/ETZCW.djhtm?c=1&etfid=MPW.US&back=ACWI
NVCR	NOVOCURE LTD	/etf/ea/ETZCW.djhtm?c=1&etfid=NVCR.US&back=ACWI
2899.HK&back=ACWI	ZIJIN MINING GROUP LTD H	/etf/ea/ETZCW.djhtm?c=1&etfid=2899.HK&back=ACWI
9843.JP&back=ACWI	NITORI HOLDINGS LTD	/etf/ea/ETZCW.djhtm?c=1&etfid=9843.JP&back=ACWI
	BANK ALJAZIRA	
601818.SH&back=ACWI	CHINA EVERBRIGHT BANK LTD A	/etf/ea/ETZCW.djhtm?c=1&etfid=601818.SH&back=ACWI
0288.HK&back=ACWI	WH GROUP LTD	/etf/ea/ETZCW.djhtm?c=1&etfid=0288.HK&back=ACWI
	ORKLA	
	TREASURY WINE ESTATES LTD	
6965.JP&back=ACWI	HAMAMATSU PHOTONICS	/etf/ea/ETZCW.djhtm?c=1&etfid=6965.JP&back=ACWI
601166.SH&back=ACWI	INDUSTRIAL BANK LTD A	/etf/ea/ETZCW.djhtm?c=1&etfid=601166.SH&back=ACWI
MASI	MASIMO CORP	/etf/ea/ETZCW.djhtm?c=1&etfid=MASI.US&back=ACWI
UGI	UGI CORP	/etf/ea/ETZCW.djhtm?c=1&etfid=UGI.US&back=ACWI
	MIRVAC GROUP STAPLED UNITS	
1171.HK&back=ACWI	YANKUANG ENERGY GROUP COMPANY LTD	/etf/ea/ETZCW.djhtm?c=1&etfid=1171.HK&back=ACWI
9503.JP&back=ACWI	KANSAI ELECTRIC POWER INC	/etf/ea/ETZCW.djhtm?c=1&etfid=9503.JP&back=ACWI
3626.JP&back=ACWI	TIS INC	/etf/ea/ETZCW.djhtm?c=1&etfid=3626.JP&back=ACWI
6506.JP&back=ACWI	YASKAWA ELECTRIC CORP	/etf/ea/ETZCW.djhtm?c=1&etfid=6506.JP&back=ACWI
	GPT GROUP STAPLED UNITS	
9531.JP&back=ACWI	TOKYO GAS LTD	/etf/ea/ETZCW.djhtm?c=1&etfid=9531.JP&back=ACWI
	ROLLS-ROYCE HOLDINGS PLC	
	WIPRO LTD	
ROL	ROLLINS INC	/etf/ea/ETZCW.djhtm?c=1&etfid=ROL.US&back=ACWI
4689.JP&back=ACWI	Z HOLDINGS CORP	/etf/ea/ETZCW.djhtm?c=1&etfid=4689.JP&back=ACWI
	CENTRAL PATTANA NON-VOTING DR PCL	
	MELROSE INDUSTRIES PLC	
2883.TW&back=ACWI	CHINA DEVELOPMENT FINANCIAL HOLDIN	/etf/ea/ETZCW.djhtm?c=1&etfid=2883.TW&back=ACWI
5713.JP&back=ACWI	SUMITOMO METAL MINING LTD	/etf/ea/ETZCW.djhtm?c=1&etfid=5713.JP&back=ACWI
	ARKEMA SA	
NI	NISOURCE INC	/etf/ea/ETZCW.djhtm?c=1&etfid=NI.US&back=ACWI
600016.SH&back=ACWI	CHINA MINSHENG BANKING CORP LTD A	/etf/ea/ETZCW.djhtm?c=1&etfid=600016.SH&back=ACWI
COIN	COINBASE GLOBAL INC CLASS A	/etf/ea/ETZCW.djhtm?c=1&etfid=COIN.US&back=ACWI
9021.JP&back=ACWI	WEST JAPAN RAILWAY	/etf/ea/ETZCW.djhtm?c=1&etfid=9021.JP&back=ACWI
	POWER GRID CORPORATION OF INDIA LT	
7701.JP&back=ACWI	SHIMADZU CORP	/etf/ea/ETZCW.djhtm?c=1&etfid=7701.JP&back=ACWI
6146.JP&back=ACWI	DISCO CORP	/etf/ea/ETZCW.djhtm?c=1&etfid=6146.JP&back=ACWI
	AMPOL LTD	
	COMMERZBANK AG	
REG	REGENCY CENTERS REIT CORP	/etf/ea/ETZCW.djhtm?c=1&etfid=REG.US&back=ACWI
0066.HK&back=ACWI	MTR CORPORATION CORP LTD	/etf/ea/ETZCW.djhtm?c=1&etfid=0066.HK&back=ACWI
	ALFA LAVAL	
	HENKEL AG	
	INFORMA PLC	
	MOWI	
LBTYK	LIBERTY GLOBAL PLC CLASS C	/etf/ea/ETZCW.djhtm?c=1&etfid=LBTYK.US&back=ACWI
	HDFC LIFE INSURANCE COMPANY LTD	
	DR REDDYS LABORATORIES LTD	
	QATAR ISLAMIC BANK	
	SKF B	
	EUROFINS SCIENTIFIC	
	NORTHERN STAR RESOURCES LTD	
373220.KS&back=ACWI	LG ENERGY SOLUTION LTD	/etf/ea/ETZCW.djhtm?c=1&etfid=373220.KS&back=ACWI
2603.TW&back=ACWI	EVERGREEN MARINE CORP (TAIWAN) LTD	/etf/ea/ETZCW.djhtm?c=1&etfid=2603.TW&back=ACWI
CGNX	COGNEX CORP	/etf/ea/ETZCW.djhtm?c=1&etfid=CGNX.US&back=ACWI
	SIAM CEMENT NON-VOTING DR PCL	
SEE	SEALED AIR CORP	/etf/ea/ETZCW.djhtm?c=1&etfid=SEE.US&back=ACWI
	MINERAL RESOURCES LTD	
	JERONIMO MARTINS SA	
TW	TRADEWEB MARKETS INC CLASS A	/etf/ea/ETZCW.djhtm?c=1&etfid=TW.US&back=ACWI
1997.HK&back=ACWI	WHARF REAL ESTATE INVESTMENT COMPA	/etf/ea/ETZCW.djhtm?c=1&etfid=1997.HK&back=ACWI
8697.JP&back=ACWI	JAPAN EXCHANGE GROUP INC	/etf/ea/ETZCW.djhtm?c=1&etfid=8697.JP&back=ACWI
	VIVENDI	
4324.JP&back=ACWI	DENTSU GROUP INC	/etf/ea/ETZCW.djhtm?c=1&etfid=4324.JP&back=ACWI
AIZ	ASSURANT INC	/etf/ea/ETZCW.djhtm?c=1&etfid=AIZ.US&back=ACWI
7202.JP&back=ACWI	ISUZU MOTORS LTD	/etf/ea/ETZCW.djhtm?c=1&etfid=7202.JP&back=ACWI
	EUR CASH	
	NEDBANK GROUP LTD	
	SAUDI BRITISH BANK	
	GILDAN ACTIVEWEAR INC	
	TATA CONSUMER PRODUCTS LTD	
	CIPLA LTD	
	IMCD NV	
7186.JP&back=ACWI	CONCORDIA FINANCIAL GROUP LTD	/etf/ea/ETZCW.djhtm?c=1&etfid=7186.JP&back=ACWI
	CEMEX CPO	
	RED ELECTRICA SA	
	GEA GROUP AG	
6479.JP&back=ACWI	MINEBEA MITSUMI INC	/etf/ea/ETZCW.djhtm?c=1&etfid=6479.JP&back=ACWI
	DIVIS LABORATORIES LTD	
7532.JP&back=ACWI	PAN PACIFIC INTERNATIONAL HOLDINGS	/etf/ea/ETZCW.djhtm?c=1&etfid=7532.JP&back=ACWI
	LOCALIZA RENT A CAR SA	
ARW	ARROW ELECTRONICS INC	/etf/ea/ETZCW.djhtm?c=1&etfid=ARW.US&back=ACWI
LII	LENNOX INTERNATIONAL INC	/etf/ea/ETZCW.djhtm?c=1&etfid=LII.US&back=ACWI
	PUMA	
3283.JP&back=ACWI	NIPPON PROLOGIS REIT INC	/etf/ea/ETZCW.djhtm?c=1&etfid=3283.JP&back=ACWI
0968.HK&back=ACWI	XINYI SOLAR HOLDINGS LTD	/etf/ea/ETZCW.djhtm?c=1&etfid=0968.HK&back=ACWI
	DKK CASH	
SIRI	SIRIUS XM HOLDINGS INC	/etf/ea/ETZCW.djhtm?c=1&etfid=SIRI.US&back=ACWI
WU	WESTERN UNION	/etf/ea/ETZCW.djhtm?c=1&etfid=WU.US&back=ACWI
8984.JP&back=ACWI	DAIWA HOUSE REIT CORP	/etf/ea/ETZCW.djhtm?c=1&etfid=8984.JP&back=ACWI
601601.SH&back=ACWI	CHINA PACIFIC INSURANCE (GROUP) LT	/etf/ea/ETZCW.djhtm?c=1&etfid=601601.SH&back=ACWI
	EQT	
NWSA	NEWS CORP CLASS A	/etf/ea/ETZCW.djhtm?c=1&etfid=NWSA.US&back=ACWI
	PANDORA	
3281.JP&back=ACWI	GLP J-REIT REIT	/etf/ea/ETZCW.djhtm?c=1&etfid=3281.JP&back=ACWI
	WISETECHGLOBAL PTY LTD	
	UMICORE SA	
	RHEINMETALL AG	
	BERKELEY GROUP HOLDINGS (THE) PLC	
KNX	KNIGHT-SWIFT TRANSPORTATION HOLDIN	/etf/ea/ETZCW.djhtm?c=1&etfid=KNX.US&back=ACWI
1821.HK&back=ACWI	ESR CAYMAN LTD	/etf/ea/ETZCW.djhtm?c=1&etfid=1821.HK&back=ACWI
600585.SH&back=ACWI	ANHUI CONCH CEMENT LTD A	/etf/ea/ETZCW.djhtm?c=1&etfid=600585.SH&back=ACWI
	AENA SME SA	
	DELIVERY HERO	
	ERSTE GROUP BANK AG	
	STOCKLAND STAPLED UNITS LTD	
	IHH HEALTHCARE	
HEI	HEICO CORP	/etf/ea/ETZCW.djhtm?c=1&etfid=HEI.US&back=ACWI
600887.SH&back=ACWI	INNER MONGOLIA YILI INDUSTRIAL GRO	/etf/ea/ETZCW.djhtm?c=1&etfid=600887.SH&back=ACWI
7261.JP&back=ACWI	MAZDA MOTOR CORP	/etf/ea/ETZCW.djhtm?c=1&etfid=7261.JP&back=ACWI
WYNN	WYNN RESORTS LTD	/etf/ea/ETZCW.djhtm?c=1&etfid=WYNN.US&back=ACWI
	BANCO DO BRASIL SA	
600048.SH&back=ACWI	POLY DEVELOPMENTS AND HOLDINGS GRO	/etf/ea/ETZCW.djhtm?c=1&etfid=600048.SH&back=ACWI
	EICHER MOTORS LTD	
BSY	BENTLEY SYSTEMS INC CLASS B	/etf/ea/ETZCW.djhtm?c=1&etfid=BSY.US&back=ACWI
	ADANI PORTS AND SPECIAL ECONOMIC Z	
	CHAROEN POKPHAND FOODS NON-VOTING	
	PETRONAS GAS	
	BRENNTAG	
	CHR HANSEN HOLDING	
9532.JP&back=ACWI	OSAKA GAS LTD	/etf/ea/ETZCW.djhtm?c=1&etfid=9532.JP&back=ACWI
OC	OWENS CORNING	/etf/ea/ETZCW.djhtm?c=1&etfid=OC.US&back=ACWI
	MEDIOBANCA BANCA DI CREDITO FINANZ	
	SCHINDLER HOLDING PAR AG	
	UNIBAIL RODAMCO WE STAPLED UNITS	
000810.KS&back=ACWI	SAMSUNG FIRE & MARINE INSURANCE LT	/etf/ea/ETZCW.djhtm?c=1&etfid=000810.KS&back=ACWI
	LAND SECURITIES GROUP REIT PLC	
	HAPVIDA PARTICIPACOES E INVESTIMEN	
FBHS	FORTUNE BRANDS HOME AND SECURITY I	/etf/ea/ETZCW.djhtm?c=1&etfid=FBHS.US&back=ACWI
	FRESENIUS MEDICAL CARE AG	
6201.JP&back=ACWI	TOYOTA INDUSTRIES CORP	/etf/ea/ETZCW.djhtm?c=1&etfid=6201.JP&back=ACWI
010130.KS&back=ACWI	KOREA ZINC INC	/etf/ea/ETZCW.djhtm?c=1&etfid=010130.KS&back=ACWI
0168.HK&back=ACWI	TSINGTAO BREWERY LTD H	/etf/ea/ETZCW.djhtm?c=1&etfid=0168.HK&back=ACWI
2880.TW&back=ACWI	HUA NAN FINANCIAL HOLDINGS LTD	/etf/ea/ETZCW.djhtm?c=1&etfid=2880.TW&back=ACWI
9042.JP&back=ACWI	HANKYU HANSHIN HOLDINGS INC	/etf/ea/ETZCW.djhtm?c=1&etfid=9042.JP&back=ACWI
	PTT EXPLORATION AND PRODUCTION NON	
	BCO BTG PACTUAL UNT SA	
	COVESTRO AG	
5201.JP&back=ACWI	AGC INC	/etf/ea/ETZCW.djhtm?c=1&etfid=5201.JP&back=ACWI
8015.JP&back=ACWI	TOYOTA TSUSHO CORP	/etf/ea/ETZCW.djhtm?c=1&etfid=8015.JP&back=ACWI
AOS	A O SMITH CORP	/etf/ea/ETZCW.djhtm?c=1&etfid=AOS.US&back=ACWI
	SEEK LTD	
4612.JP&back=ACWI	NIPPON PAINT HOLDINGS LTD	/etf/ea/ETZCW.djhtm?c=1&etfid=4612.JP&back=ACWI
	ENDEAVOUR GROUP LTD	
GWRE	GUIDEWIRE SOFTWARE INC	/etf/ea/ETZCW.djhtm?c=1&etfid=GWRE.US&back=ACWI
8830.JP&back=ACWI	SUMITOMO REALTY & DEVELOPMENT LTD	/etf/ea/ETZCW.djhtm?c=1&etfid=8830.JP&back=ACWI
2382.TW&back=ACWI	QUANTA COMPUTER INC	/etf/ea/ETZCW.djhtm?c=1&etfid=2382.TW&back=ACWI
	APOLLO HOSPITALS ENTERPRISE LTD	
	BANK NEGARA INDONESIA	
	ELBIT SYSTEMS LTD	
	TEMENOS AG	
	HEIDELBERGCEMENT AG	
003550.KS&back=ACWI	LG CORP	/etf/ea/ETZCW.djhtm?c=1&etfid=003550.KS&back=ACWI
	ADVANCED INFO SERVICE NON-VOTING D	
1919.HK&back=ACWI	COSCO SHIPPING HOLDINGS LTD H	/etf/ea/ETZCW.djhtm?c=1&etfid=1919.HK&back=ACWI
8795.JP&back=ACWI	T&D HOLDINGS INC	/etf/ea/ETZCW.djhtm?c=1&etfid=8795.JP&back=ACWI
	GRASIM INDUSTRIES LTD	
	SAGE GROUP PLC	
	HONG LEONG FINANCIAL GROUP	
4904.TW&back=ACWI	FAR EASTONE TELECOMMUNICATIONS LTD	/etf/ea/ETZCW.djhtm?c=1&etfid=4904.TW&back=ACWI
3045.TW&back=ACWI	TAIWAN MOBILE LTD	/etf/ea/ETZCW.djhtm?c=1&etfid=3045.TW&back=ACWI
7912.JP&back=ACWI	DAI NIPPON PRINTING LTD	/etf/ea/ETZCW.djhtm?c=1&etfid=7912.JP&back=ACWI
	RENAULT SA	
4021.JP&back=ACWI	NISSAN CHEMICAL CORP	/etf/ea/ETZCW.djhtm?c=1&etfid=4021.JP&back=ACWI
	CONTINENTAL AG	
LCID	LUCID GROUP INC	/etf/ea/ETZCW.djhtm?c=1&etfid=LCID.US&back=ACWI
8601.JP&back=ACWI	DAIWA SECURITIES GROUP INC	/etf/ea/ETZCW.djhtm?c=1&etfid=8601.JP&back=ACWI
	ASSOCIATED BRITISH FOODS PLC	
0992.HK&back=ACWI	LENOVO GROUP LTD	/etf/ea/ETZCW.djhtm?c=1&etfid=0992.HK&back=ACWI
	KINGFISHER PLC	
	HALMA PLC	
	WEST FRASER TIMBER LTD	
4188.JP&back=ACWI	MITSUBISHI CHEMICAL GROUP CORP	/etf/ea/ETZCW.djhtm?c=1&etfid=4188.JP&back=ACWI
3037.TW&back=ACWI	UNIMICRON TECHNOLOGY CORP	/etf/ea/ETZCW.djhtm?c=1&etfid=3037.TW&back=ACWI
DVA	DAVITA INC	/etf/ea/ETZCW.djhtm?c=1&etfid=DVA.US&back=ACWI
2328.HK&back=ACWI	PICC PROPERTY AND CASUALTY LTD H	/etf/ea/ETZCW.djhtm?c=1&etfid=2328.HK&back=ACWI
	UNITED TRACTORS	
	SUZANO SA	
600309.SH&back=ACWI	WANHUA CHEMICAL GROUP LTD A	/etf/ea/ETZCW.djhtm?c=1&etfid=600309.SH&back=ACWI
ARMK	ARAMARK	/etf/ea/ETZCW.djhtm?c=1&etfid=ARMK.US&back=ACWI
034730.KS&back=ACWI	SK INC	/etf/ea/ETZCW.djhtm?c=1&etfid=034730.KS&back=ACWI
2207.TW&back=ACWI	HOTAI MOTOR LTD	/etf/ea/ETZCW.djhtm?c=1&etfid=2207.TW&back=ACWI
2885.TW&back=ACWI	YUANTA FINANCIAL HOLDING LTD	/etf/ea/ETZCW.djhtm?c=1&etfid=2885.TW&back=ACWI
4732.JP&back=ACWI	USS LTD	/etf/ea/ETZCW.djhtm?c=1&etfid=4732.JP&back=ACWI
	ALSTOM SA	
	MONCLER	
1101.TW&back=ACWI	TAIWAN CEMENT CORP	/etf/ea/ETZCW.djhtm?c=1&etfid=1101.TW&back=ACWI
	ALMARAI	
	ANTOFAGASTA PLC	
9501.JP&back=ACWI	TOKYO ELECTRIC POWER HOLDINGS INC	/etf/ea/ETZCW.djhtm?c=1&etfid=9501.JP&back=ACWI
	CHF CASH	
6963.JP&back=ACWI	ROHM LTD	/etf/ea/ETZCW.djhtm?c=1&etfid=6963.JP&back=ACWI
MHK	MOHAWK INDUSTRIES INC	/etf/ea/ETZCW.djhtm?c=1&etfid=MHK.US&back=ACWI
HEI.A	HEICO CORP CLASS A	/etf/ea/ETZCW.djhtm?c=1&etfid=HEI.A.US&back=ACWI
	UNITED UTILITIES GROUP PLC	
	VAT GROUP AG	
002142.SZ&back=ACWI	BANK OF NINGBO LTD A	/etf/ea/ETZCW.djhtm?c=1&etfid=002142.SZ&back=ACWI
	ACS ACTIVIDADES DE CONSTRUCCION Y	
8953.JP&back=ACWI	JAPAN METROPOLITAN FUND INVESTMENT	/etf/ea/ETZCW.djhtm?c=1&etfid=8953.JP&back=ACWI
	EMERA INC	
034020.KS&back=ACWI	DOOSAN ENERBILITY LTD	/etf/ea/ETZCW.djhtm?c=1&etfid=034020.KS&back=ACWI
601658.SH&back=ACWI	POSTAL SAVINGS BANK OF CHINA LTD A	/etf/ea/ETZCW.djhtm?c=1&etfid=601658.SH&back=ACWI
	ABSA GROUP LTD	
6806.JP&back=ACWI	HIROSE ELECTRIC LTD	/etf/ea/ETZCW.djhtm?c=1&etfid=6806.JP&back=ACWI
	HANNOVER RUECK	
9602.JP&back=ACWI	TOHO (TOKYO) LTD	/etf/ea/ETZCW.djhtm?c=1&etfid=9602.JP&back=ACWI
4151.JP&back=ACWI	KYOWA KIRIN LTD	/etf/ea/ETZCW.djhtm?c=1&etfid=4151.JP&back=ACWI
	VICINITY CENTRES	
	EDP RENOVAVEIS SA	
2897.JP&back=ACWI	NISSIN FOODS HOLDINGS LTD	/etf/ea/ETZCW.djhtm?c=1&etfid=2897.JP&back=ACWI
	KESKO CLASS B	
Z	ZILLOW GROUP INC CLASS C	/etf/ea/ETZCW.djhtm?c=1&etfid=Z.US&back=ACWI
	SCHINDLER HOLDING AG	
EXAS	EXACT SCIENCES CORP	/etf/ea/ETZCW.djhtm?c=1&etfid=EXAS.US&back=ACWI
DBX	DROPBOX INC CLASS A	/etf/ea/ETZCW.djhtm?c=1&etfid=DBX.US&back=ACWI
CABO	CABLE ONE INC	/etf/ea/ETZCW.djhtm?c=1&etfid=CABO.US&back=ACWI
	SIEMENS ENERGY N AG	
	OOREDOO	
603259.SH&back=ACWI	WUXI APPTEC LTD A	/etf/ea/ETZCW.djhtm?c=1&etfid=603259.SH&back=ACWI
	GEORGE WESTON LTD	
7182.JP&back=ACWI	JAPAN POST BANK LTD	/etf/ea/ETZCW.djhtm?c=1&etfid=7182.JP&back=ACWI
4204.JP&back=ACWI	SEKISUI CHEMICAL LTD	/etf/ea/ETZCW.djhtm?c=1&etfid=4204.JP&back=ACWI
	PRESS METAL ALUMINIUM HOLDINGS	
6504.JP&back=ACWI	FUJI ELECTRIC LTD	/etf/ea/ETZCW.djhtm?c=1&etfid=6504.JP&back=ACWI
000002.SZ&back=ACWI	CHINA VANKE LTD A	/etf/ea/ETZCW.djhtm?c=1&etfid=000002.SZ&back=ACWI
000001.SZ&back=ACWI	PING AN BANK LTD A	/etf/ea/ETZCW.djhtm?c=1&etfid=000001.SZ&back=ACWI
	JBS SA	
	INTERCONTINENTAL HOTELS GROUP PLC	
	ORICA LTD	
	ELECTRICITE DE FRANCE SA	
	HONGKONG LAND HOLDINGS LTD	
	INDUSTRIES QATAR	
051900.KS&back=ACWI	LG H & H LTD	/etf/ea/ETZCW.djhtm?c=1&etfid=051900.KS&back=ACWI
	THE PUBLIC WAREHOUSING (AGILITY)	
ST	SENSATA TECHNOLOGIES HOLDING PLC	/etf/ea/ETZCW.djhtm?c=1&etfid=ST.US&back=ACWI
601225.SH&back=ACWI	SHAANXI COAL INDUSTRY LTD A	/etf/ea/ETZCW.djhtm?c=1&etfid=601225.SH&back=ACWI
001979.SZ&back=ACWI	CHINA MERCHANTS SHEKOU INDUSTRIAL	/etf/ea/ETZCW.djhtm?c=1&etfid=001979.SZ&back=ACWI
	BRITISH LAND REIT PLC	
1177.HK&back=ACWI	SINO BIOPHARMACEUTICAL LTD	/etf/ea/ETZCW.djhtm?c=1&etfid=1177.HK&back=ACWI
UHS	UNIVERSAL HEALTH SERVICES INC CLAS	/etf/ea/ETZCW.djhtm?c=1&etfid=UHS.US&back=ACWI
	VERBUND AG	
2269.JP&back=ACWI	MEIJI HOLDINGS LTD	/etf/ea/ETZCW.djhtm?c=1&etfid=2269.JP&back=ACWI
6415.TW&back=ACWI	SILERGY CORP	/etf/ea/ETZCW.djhtm?c=1&etfid=6415.TW&back=ACWI
9005.JP&back=ACWI	TOKYU CORP	/etf/ea/ETZCW.djhtm?c=1&etfid=9005.JP&back=ACWI
	RUMO SA	
	PERSIMMON PLC	
2379.TW&back=ACWI	REALTEK SEMICONDUCTOR CORP	/etf/ea/ETZCW.djhtm?c=1&etfid=2379.TW&back=ACWI
5876.TW&back=ACWI	SHANGHAI COMMERCIAL LTD	/etf/ea/ETZCW.djhtm?c=1&etfid=5876.TW&back=ACWI
	ENDESA SA	
9041.JP&back=ACWI	KINTETSU GROUP HOLDINGS LTD	/etf/ea/ETZCW.djhtm?c=1&etfid=9041.JP&back=ACWI
	BRITANNIA INDUSTRIES LTD	
3008.TW&back=ACWI	LARGAN PRECISION LTD	/etf/ea/ETZCW.djhtm?c=1&etfid=3008.TW&back=ACWI
	OTP BANK	
	SMITHS GROUP PLC	
