DON
CAH	Cardinal Health Inc	/etf/ea/ETZCW.djhtm?c=1&etfid=CAH.US&back=DON
EVRG	Evergy Inc	/etf/ea/ETZCW.djhtm?c=1&etfid=EVRG.US&back=DON
CLR	Continental Resources Inc/OK	/etf/ea/ETZCW.djhtm?c=1&etfid=CLR.US&back=DON
CTRA	Coterra Energy Inc	/etf/ea/ETZCW.djhtm?c=1&etfid=CTRA.US&back=DON
CAG	Conagra Brands Inc	/etf/ea/ETZCW.djhtm?c=1&etfid=CAG.US&back=DON
FNF	Fidelity National Financial Inc	/etf/ea/ETZCW.djhtm?c=1&etfid=FNF.US&back=DON
OMC	Omnicom Group Inc	/etf/ea/ETZCW.djhtm?c=1&etfid=OMC.US&back=DON
CPB	Campbell Soup Co	/etf/ea/ETZCW.djhtm?c=1&etfid=CPB.US&back=DON
OGE	OGE Energy Corp	/etf/ea/ETZCW.djhtm?c=1&etfid=OGE.US&back=DON
CNP	Centerpoint Energy Inc	/etf/ea/ETZCW.djhtm?c=1&etfid=CNP.US&back=DON
CF	CF Industries Holdings Inc	/etf/ea/ETZCW.djhtm?c=1&etfid=CF.US&back=DON
AM	Antero Midstream Corp	/etf/ea/ETZCW.djhtm?c=1&etfid=AM.US&back=DON
SJM	JM Smucker Co/The	/etf/ea/ETZCW.djhtm?c=1&etfid=SJM.US&back=DON
BEN	Franklin Resources Inc	/etf/ea/ETZCW.djhtm?c=1&etfid=BEN.US&back=DON
WPC	WP Carey Inc	/etf/ea/ETZCW.djhtm?c=1&etfid=WPC.US&back=DON
IRM	Iron Mountain Inc	/etf/ea/ETZCW.djhtm?c=1&etfid=IRM.US&back=DON
ATO	Atmos Energy Corp	/etf/ea/ETZCW.djhtm?c=1&etfid=ATO.US&back=DON
FHN	First Horizon Corp	/etf/ea/ETZCW.djhtm?c=1&etfid=FHN.US&back=DON
LNT	Alliant Energy Corp	/etf/ea/ETZCW.djhtm?c=1&etfid=LNT.US&back=DON
AES	AES Corp/The	/etf/ea/ETZCW.djhtm?c=1&etfid=AES.US&back=DON
OGN	Organon & Co	/etf/ea/ETZCW.djhtm?c=1&etfid=OGN.US&back=DON
UNM	Unum Group	/etf/ea/ETZCW.djhtm?c=1&etfid=UNM.US&back=DON
NI	Nisource Inc	/etf/ea/ETZCW.djhtm?c=1&etfid=NI.US&back=DON
UGI	UGI Corp	/etf/ea/ETZCW.djhtm?c=1&etfid=UGI.US&back=DON
HRB	H&R Block Inc	/etf/ea/ETZCW.djhtm?c=1&etfid=HRB.US&back=DON
CNA	CNA Financial Corp	/etf/ea/ETZCW.djhtm?c=1&etfid=CNA.US&back=DON
GLPI	Gaming & Leisure Porperties Inc	/etf/ea/ETZCW.djhtm?c=1&etfid=GLPI.US&back=DON
PKG	Packaging Corp of America	/etf/ea/ETZCW.djhtm?c=1&etfid=PKG.US&back=DON
OMF	Onemain Holdings Inc	/etf/ea/ETZCW.djhtm?c=1&etfid=OMF.US&back=DON
DINO	HF Sinclair Corp	/etf/ea/ETZCW.djhtm?c=1&etfid=DINO.US&back=DON
ORI	Old Republic International Corp	/etf/ea/ETZCW.djhtm?c=1&etfid=ORI.US&back=DON
WSO	Watsco Inc	/etf/ea/ETZCW.djhtm?c=1&etfid=WSO.US&back=DON
OVV	Ovintiv Inc	/etf/ea/ETZCW.djhtm?c=1&etfid=OVV.US&back=DON
IPG	Interpublic Group of Cos Inc	/etf/ea/ETZCW.djhtm?c=1&etfid=IPG.US&back=DON
NRG	NRG Energy Inc	/etf/ea/ETZCW.djhtm?c=1&etfid=NRG.US&back=DON
CHK	Chesapeake Energy Corp	/etf/ea/ETZCW.djhtm?c=1&etfid=CHK.US&back=DON
CMA	Comerica Inc	/etf/ea/ETZCW.djhtm?c=1&etfid=CMA.US&back=DON
RS	Reliance Steel & Aluminum Co	/etf/ea/ETZCW.djhtm?c=1&etfid=RS.US&back=DON
MRO	Marathon Oil Corp	/etf/ea/ETZCW.djhtm?c=1&etfid=MRO.US&back=DON
NWL	Newell Brands Inc	/etf/ea/ETZCW.djhtm?c=1&etfid=NWL.US&back=DON
SNA	Snap-On Inc	/etf/ea/ETZCW.djhtm?c=1&etfid=SNA.US&back=DON
CHRW	CH Robinson Worldwide Inc	/etf/ea/ETZCW.djhtm?c=1&etfid=CHRW.US&back=DON
EMN	Eastman Chemical Co	/etf/ea/ETZCW.djhtm?c=1&etfid=EMN.US&back=DON
NFG	National Fuel Gas Co	/etf/ea/ETZCW.djhtm?c=1&etfid=NFG.US&back=DON
ARES	Ares Management Corp - A	/etf/ea/ETZCW.djhtm?c=1&etfid=ARES.US&back=DON
FLO	Flowers Foods Inc	/etf/ea/ETZCW.djhtm?c=1&etfid=FLO.US&back=DON
STLD	Steel Dynamics Inc	/etf/ea/ETZCW.djhtm?c=1&etfid=STLD.US&back=DON
MDU	MDU Resources Group Inc	/etf/ea/ETZCW.djhtm?c=1&etfid=MDU.US&back=DON
JEF	Jefferies Financial Group Inc	/etf/ea/ETZCW.djhtm?c=1&etfid=JEF.US&back=DON
HAS	Hasbro Inc	/etf/ea/ETZCW.djhtm?c=1&etfid=HAS.US&back=DON
APA	APA Corp	/etf/ea/ETZCW.djhtm?c=1&etfid=APA.US&back=DON
NLOK	Nortonlifelock Inc	/etf/ea/ETZCW.djhtm?c=1&etfid=NLOK.US&back=DON
WTRG	Essential Utilities Inc	/etf/ea/ETZCW.djhtm?c=1&etfid=WTRG.US&back=DON
CIVI	Civitas Resources Inc	/etf/ea/ETZCW.djhtm?c=1&etfid=CIVI.US&back=DON
DTM	DT Midstream Inc	/etf/ea/ETZCW.djhtm?c=1&etfid=DTM.US&back=DON
WSM	Williams-Sonoma Inc	/etf/ea/ETZCW.djhtm?c=1&etfid=WSM.US&back=DON
ACI	Albertsons Cos Inc - Class A	/etf/ea/ETZCW.djhtm?c=1&etfid=ACI.US&back=DON
AFG	American Financial Group Inc	/etf/ea/ETZCW.djhtm?c=1&etfid=AFG.US&back=DON
OHI	Omega Healthcare Investors Inc	/etf/ea/ETZCW.djhtm?c=1&etfid=OHI.US&back=DON
PAG	Penske Auto Group Inc	/etf/ea/ETZCW.djhtm?c=1&etfid=PAG.US&back=DON
LKQ	LKQ Corp	/etf/ea/ETZCW.djhtm?c=1&etfid=LKQ.US&back=DON
EWBC	East West Bancorp Inc	/etf/ea/ETZCW.djhtm?c=1&etfid=EWBC.US&back=DON
NYCB	New York Community Bancorp Inc	/etf/ea/ETZCW.djhtm?c=1&etfid=NYCB.US&back=DON
TFSL	TFS Financial Corp	/etf/ea/ETZCW.djhtm?c=1&etfid=TFSL.US&back=DON
HII	Huntington Ingalls Industries Inc	/etf/ea/ETZCW.djhtm?c=1&etfid=HII.US&back=DON
MAS	Masco Corp	/etf/ea/ETZCW.djhtm?c=1&etfid=MAS.US&back=DON
CWEN	Clearway Energy Inc	/etf/ea/ETZCW.djhtm?c=1&etfid=CWEN.US&back=DON
JNPR	Juniper Networks Inc	/etf/ea/ETZCW.djhtm?c=1&etfid=JNPR.US&back=DON
FMC	FMC Corp	/etf/ea/ETZCW.djhtm?c=1&etfid=FMC.US&back=DON
HUBB	Hubbell Inc	/etf/ea/ETZCW.djhtm?c=1&etfid=HUBB.US&back=DON
ETRN	Equitrans Midstream Corp	/etf/ea/ETZCW.djhtm?c=1&etfid=ETRN.US&back=DON
ALLY	Ally Financial Inc	/etf/ea/ETZCW.djhtm?c=1&etfid=ALLY.US&back=DON
UMPQ	Umpqua Holdings Corp	/etf/ea/ETZCW.djhtm?c=1&etfid=UMPQ.US&back=DON
WRK	Westrock Co	/etf/ea/ETZCW.djhtm?c=1&etfid=WRK.US&back=DON
FAF	First American Financial Corp	/etf/ea/ETZCW.djhtm?c=1&etfid=FAF.US&back=DON
RGA	Reinsurance Group of America Inc	/etf/ea/ETZCW.djhtm?c=1&etfid=RGA.US&back=DON
IDA	IDACORP Inc	/etf/ea/ETZCW.djhtm?c=1&etfid=IDA.US&back=DON
ERIE	Erie Indemnity Co	/etf/ea/ETZCW.djhtm?c=1&etfid=ERIE.US&back=DON
TPR	Tapestry Inc	/etf/ea/ETZCW.djhtm?c=1&etfid=TPR.US&back=DON
LNC	Lincoln National Corp	/etf/ea/ETZCW.djhtm?c=1&etfid=LNC.US&back=DON
WHR	Whirlpool Corp	/etf/ea/ETZCW.djhtm?c=1&etfid=WHR.US&back=DON
NXST	Nexstar Media Group Inc	/etf/ea/ETZCW.djhtm?c=1&etfid=NXST.US&back=DON
SCI	Service Corp International	/etf/ea/ETZCW.djhtm?c=1&etfid=SCI.US&back=DON
LECO	Lincoln Electric Holdings Inc	/etf/ea/ETZCW.djhtm?c=1&etfid=LECO.US&back=DON
BPOP	Popular Inc	/etf/ea/ETZCW.djhtm?c=1&etfid=BPOP.US&back=DON
LEG	Leggett & Platt Inc	/etf/ea/ETZCW.djhtm?c=1&etfid=LEG.US&back=DON
BAH	Booz Allen Hamilton Holding Co	/etf/ea/ETZCW.djhtm?c=1&etfid=BAH.US&back=DON
OLN	Olin Corp	/etf/ea/ETZCW.djhtm?c=1&etfid=OLN.US&back=DON
LDOS	Leidos Holdings Inc.	/etf/ea/ETZCW.djhtm?c=1&etfid=LDOS.US&back=DON
RPM	RPM International Inc	/etf/ea/ETZCW.djhtm?c=1&etfid=RPM.US&back=DON
CFR	Cullen/Frost Bankers Inc	/etf/ea/ETZCW.djhtm?c=1&etfid=CFR.US&back=DON
CE	Celanese Corp	/etf/ea/ETZCW.djhtm?c=1&etfid=CE.US&back=DON
ZION	Zions Bancorporation	/etf/ea/ETZCW.djhtm?c=1&etfid=ZION.US&back=DON
KIM	Kimco Realty Corp	/etf/ea/ETZCW.djhtm?c=1&etfid=KIM.US&back=DON
SON	Sonoco Products Co	/etf/ea/ETZCW.djhtm?c=1&etfid=SON.US&back=DON
NNN	National Retail Properties Inc	/etf/ea/ETZCW.djhtm?c=1&etfid=NNN.US&back=DON
TRGP	Targa Resources Corp	/etf/ea/ETZCW.djhtm?c=1&etfid=TRGP.US&back=DON
ROL	Rollins Inc	/etf/ea/ETZCW.djhtm?c=1&etfid=ROL.US&back=DON
UBSI	United Bankshares Inc	/etf/ea/ETZCW.djhtm?c=1&etfid=UBSI.US&back=DON
CC	Chemours Co/The	/etf/ea/ETZCW.djhtm?c=1&etfid=CC.US&back=DON
CBOE	Cboe Global Markets Inc	/etf/ea/ETZCW.djhtm?c=1&etfid=CBOE.US&back=DON
REYN	Reynolds Consumer Products Inc	/etf/ea/ETZCW.djhtm?c=1&etfid=REYN.US&back=DON
OZK	Bank Ozk	/etf/ea/ETZCW.djhtm?c=1&etfid=OZK.US&back=DON
BOKF	BOK Financial Corp	/etf/ea/ETZCW.djhtm?c=1&etfid=BOKF.US&back=DON
BKH	Black Hills Corp	/etf/ea/ETZCW.djhtm?c=1&etfid=BKH.US&back=DON
TPL	Texas Pacific Land Corp	/etf/ea/ETZCW.djhtm?c=1&etfid=TPL.US&back=DON
PB	Prosperity Bancshares Inc	/etf/ea/ETZCW.djhtm?c=1&etfid=PB.US&back=DON
AAP	Advance Auto Parts Inc	/etf/ea/ETZCW.djhtm?c=1&etfid=AAP.US&back=DON
CUBE	CubeSmart	/etf/ea/ETZCW.djhtm?c=1&etfid=CUBE.US&back=DON
R	Ryder System Inc	/etf/ea/ETZCW.djhtm?c=1&etfid=R.US&back=DON
DKS	Dick\''s Sporting Goods Inc	/etf/ea/ETZCW.djhtm?c=1&etfid=DKS.US&back=DON
CBSH	Commerce Bancshares Inc/Kansas	/etf/ea/ETZCW.djhtm?c=1&etfid=CBSH.US&back=DON
RHI	Robert Half International Inc	/etf/ea/ETZCW.djhtm?c=1&etfid=RHI.US&back=DON
WBS	Webster Financial Corp	/etf/ea/ETZCW.djhtm?c=1&etfid=WBS.US&back=DON
SNV	Synovus Financial Corp	/etf/ea/ETZCW.djhtm?c=1&etfid=SNV.US&back=DON
MOS	Mosaic Co/The	/etf/ea/ETZCW.djhtm?c=1&etfid=MOS.US&back=DON
WLK	Westlake Corp	/etf/ea/ETZCW.djhtm?c=1&etfid=WLK.US&back=DON
POR	Portland General Electric Co	/etf/ea/ETZCW.djhtm?c=1&etfid=POR.US&back=DON
PII	Polaris Inc	/etf/ea/ETZCW.djhtm?c=1&etfid=PII.US&back=DON
STOR	STORE Capital Corp	/etf/ea/ETZCW.djhtm?c=1&etfid=STOR.US&back=DON
INGR	Ingredion Inc	/etf/ea/ETZCW.djhtm?c=1&etfid=INGR.US&back=DON
WRB	WR Berkley Corp	/etf/ea/ETZCW.djhtm?c=1&etfid=WRB.US&back=DON
HR	Healthcare Realty Trust Inc	/etf/ea/ETZCW.djhtm?c=1&etfid=HR.US&back=DON
AIZ	Assurant Inc	/etf/ea/ETZCW.djhtm?c=1&etfid=AIZ.US&back=DON
HE	Hawaiian Electric Industries Inc	/etf/ea/ETZCW.djhtm?c=1&etfid=HE.US&back=DON
LSI	Life Storage Inc	/etf/ea/ETZCW.djhtm?c=1&etfid=LSI.US&back=DON
NATI	National Instruments Corp	/etf/ea/ETZCW.djhtm?c=1&etfid=NATI.US&back=DON
FCNCA	First Citizens BancShares Inc/	/etf/ea/ETZCW.djhtm?c=1&etfid=FCNCA.US&back=DON
JKHY	Jack Henry & Associates Inc	/etf/ea/ETZCW.djhtm?c=1&etfid=JKHY.US&back=DON
BWA	BorgWarner Inc	/etf/ea/ETZCW.djhtm?c=1&etfid=BWA.US&back=DON
VLY	Valley National Bancorp	/etf/ea/ETZCW.djhtm?c=1&etfid=VLY.US&back=DON
TTC	Toro Co	/etf/ea/ETZCW.djhtm?c=1&etfid=TTC.US&back=DON
GGG	Graco Inc	/etf/ea/ETZCW.djhtm?c=1&etfid=GGG.US&back=DON
DCI	Donaldson Co Inc	/etf/ea/ETZCW.djhtm?c=1&etfid=DCI.US&back=DON
LAMR	Lamar Advertising Co	/etf/ea/ETZCW.djhtm?c=1&etfid=LAMR.US&back=DON
WAL	Western Alliance Bancorp	/etf/ea/ETZCW.djhtm?c=1&etfid=WAL.US&back=DON
GNTX	Gentex Corp	/etf/ea/ETZCW.djhtm?c=1&etfid=GNTX.US&back=DON
THG	Hanover Insurance Group Inc/The	/etf/ea/ETZCW.djhtm?c=1&etfid=THG.US&back=DON
NDSN	Nordson Corp	/etf/ea/ETZCW.djhtm?c=1&etfid=NDSN.US&back=DON
CSL	Carlisle Cos Inc	/etf/ea/ETZCW.djhtm?c=1&etfid=CSL.US&back=DON
SRC	Spirit Realty Capital Inc	/etf/ea/ETZCW.djhtm?c=1&etfid=SRC.US&back=DON
BRX	Brixmor Property Group Inc	/etf/ea/ETZCW.djhtm?c=1&etfid=BRX.US&back=DON
GBCI	Glacier Bancorp Inc	/etf/ea/ETZCW.djhtm?c=1&etfid=GBCI.US&back=DON
HUN	Huntsman Corp	/etf/ea/ETZCW.djhtm?c=1&etfid=HUN.US&back=DON
PINC	Premier Inc	/etf/ea/ETZCW.djhtm?c=1&etfid=PINC.US&back=DON
WH	Wyndham Hotels & Resorts Inc	/etf/ea/ETZCW.djhtm?c=1&etfid=WH.US&back=DON
LEA	Lear Corp	/etf/ea/ETZCW.djhtm?c=1&etfid=LEA.US&back=DON
CR	Crane Holdings Co	/etf/ea/ETZCW.djhtm?c=1&etfid=CR.US&back=DON
LPLA	LPL Financial Holdings Inc	/etf/ea/ETZCW.djhtm?c=1&etfid=LPLA.US&back=DON
RRX	Regal Rexnord Corp	/etf/ea/ETZCW.djhtm?c=1&etfid=RRX.US&back=DON
REG	Regency Centers Corp	/etf/ea/ETZCW.djhtm?c=1&etfid=REG.US&back=DON
TGNA	Tegna Inc	/etf/ea/ETZCW.djhtm?c=1&etfid=TGNA.US&back=DON
VVV	Valvoline Inc	/etf/ea/ETZCW.djhtm?c=1&etfid=VVV.US&back=DON
EVR	Evercore Inc	/etf/ea/ETZCW.djhtm?c=1&etfid=EVR.US&back=DON
SSB	SouthState Corp	/etf/ea/ETZCW.djhtm?c=1&etfid=SSB.US&back=DON
MAN	Manpower Inc	/etf/ea/ETZCW.djhtm?c=1&etfid=MAN.US&back=DON
CADE	Cadence Bank	/etf/ea/ETZCW.djhtm?c=1&etfid=CADE.US&back=DON
SEE	Sealed Air Corp	/etf/ea/ETZCW.djhtm?c=1&etfid=SEE.US&back=DON
ARMK	Aramark	/etf/ea/ETZCW.djhtm?c=1&etfid=ARMK.US&back=DON
HBI	Hanesbrands Inc	/etf/ea/ETZCW.djhtm?c=1&etfid=HBI.US&back=DON
TNL	Travel + Leisure Co	/etf/ea/ETZCW.djhtm?c=1&etfid=TNL.US&back=DON
TXRH	Texas Roadhouse Inc	/etf/ea/ETZCW.djhtm?c=1&etfid=TXRH.US&back=DON
NSP	Insperity Inc	/etf/ea/ETZCW.djhtm?c=1&etfid=NSP.US&back=DON
NOV	NOV Inc	/etf/ea/ETZCW.djhtm?c=1&etfid=NOV.US&back=DON
MUR	Murphy Oil Corp	/etf/ea/ETZCW.djhtm?c=1&etfid=MUR.US&back=DON
ELS	Equity Lifestyle Properties Inc	/etf/ea/ETZCW.djhtm?c=1&etfid=ELS.US&back=DON
LII	Lennox International Inc	/etf/ea/ETZCW.djhtm?c=1&etfid=LII.US&back=DON
PACW	PacWest Bancorp	/etf/ea/ETZCW.djhtm?c=1&etfid=PACW.US&back=DON
HLI	Houlihan Lokey Inc	/etf/ea/ETZCW.djhtm?c=1&etfid=HLI.US&back=DON
M	Macy's Inc	/etf/ea/ETZCW.djhtm?c=1&etfid=M.US&back=DON
GPK	Graphic Packaging Holding Co	/etf/ea/ETZCW.djhtm?c=1&etfid=GPK.US&back=DON
FL	Foot Locker Inc	/etf/ea/ETZCW.djhtm?c=1&etfid=FL.US&back=DON
CNS	Cohen & Steers Inc	/etf/ea/ETZCW.djhtm?c=1&etfid=CNS.US&back=DON
HOMB	Home Bancshares Inc/Conway AR	/etf/ea/ETZCW.djhtm?c=1&etfid=HOMB.US&back=DON
SEIC	SEI Investments Co	/etf/ea/ETZCW.djhtm?c=1&etfid=SEIC.US&back=DON
SIGI	Selective Insurance Group	/etf/ea/ETZCW.djhtm?c=1&etfid=SIGI.US&back=DON
LANC	Lancaster Colony Corp	/etf/ea/ETZCW.djhtm?c=1&etfid=LANC.US&back=DON
FFIN	First Financial Bankshares Inc	/etf/ea/ETZCW.djhtm?c=1&etfid=FFIN.US&back=DON
PHM	Pulte Homes Inc	/etf/ea/ETZCW.djhtm?c=1&etfid=PHM.US&back=DON
TKR	Timken Co	/etf/ea/ETZCW.djhtm?c=1&etfid=TKR.US&back=DON
MTN	Vail Resorts Inc	/etf/ea/ETZCW.djhtm?c=1&etfid=MTN.US&back=DON
SLM	SLM Corp	/etf/ea/ETZCW.djhtm?c=1&etfid=SLM.US&back=DON
MTG	MGIC Investment Corp	/etf/ea/ETZCW.djhtm?c=1&etfid=MTG.US&back=DON
NWSA	News Corp	/etf/ea/ETZCW.djhtm?c=1&etfid=NWSA.US&back=DON
AOS	AO Smith Corp	/etf/ea/ETZCW.djhtm?c=1&etfid=AOS.US&back=DON
HOG	Harley-Davidson Inc	/etf/ea/ETZCW.djhtm?c=1&etfid=HOG.US&back=DON
KRC	Kilroy Realty Corp	/etf/ea/ETZCW.djhtm?c=1&etfid=KRC.US&back=DON
OWL	Blue Owl Capital Inc	/etf/ea/ETZCW.djhtm?c=1&etfid=OWL.US&back=DON
PDCE	PDC Energy Inc	/etf/ea/ETZCW.djhtm?c=1&etfid=PDCE.US&back=DON
GPS	Gap Inc/The	/etf/ea/ETZCW.djhtm?c=1&etfid=GPS.US&back=DON
FRT	Federal Realty Invs Trust	/etf/ea/ETZCW.djhtm?c=1&etfid=FRT.US&back=DON
BC	Brunswick Corp/DE	/etf/ea/ETZCW.djhtm?c=1&etfid=BC.US&back=DON
STAG	STAG Industrial Inc	/etf/ea/ETZCW.djhtm?c=1&etfid=STAG.US&back=DON
RL	Ralph Lauren Corp	/etf/ea/ETZCW.djhtm?c=1&etfid=RL.US&back=DON
HWC	Hancock Whitney Corp	/etf/ea/ETZCW.djhtm?c=1&etfid=HWC.US&back=DON
SAIC	Science Applications International Corp	/etf/ea/ETZCW.djhtm?c=1&etfid=SAIC.US&back=DON
EHC	Encompass Health Corp	/etf/ea/ETZCW.djhtm?c=1&etfid=EHC.US&back=DON
ADT	ADT Inc	/etf/ea/ETZCW.djhtm?c=1&etfid=ADT.US&back=DON
UMBF	UMB Financial Corp	/etf/ea/ETZCW.djhtm?c=1&etfid=UMBF.US&back=DON
OC	Owens Corning	/etf/ea/ETZCW.djhtm?c=1&etfid=OC.US&back=DON
PRI	Primerica Inc	/etf/ea/ETZCW.djhtm?c=1&etfid=PRI.US&back=DON
RGLD	Royal Gold Inc	/etf/ea/ETZCW.djhtm?c=1&etfid=RGLD.US&back=DON
CCK	Crown Holdings Inc	/etf/ea/ETZCW.djhtm?c=1&etfid=CCK.US&back=DON
SLGN	Silgan Holdings Inc	/etf/ea/ETZCW.djhtm?c=1&etfid=SLGN.US&back=DON
LPX	Louisiana-Pacific Corp	/etf/ea/ETZCW.djhtm?c=1&etfid=LPX.US&back=DON
WEN	Wendy's Co/The	/etf/ea/ETZCW.djhtm?c=1&etfid=WEN.US&back=DON
GL	Globe Life Inc	/etf/ea/ETZCW.djhtm?c=1&etfid=GL.US&back=DON
VAC	Marriott Vacations Worldwide	/etf/ea/ETZCW.djhtm?c=1&etfid=VAC.US&back=DON
KSS	Kohl's Corp	/etf/ea/ETZCW.djhtm?c=1&etfid=KSS.US&back=DON
THO	Thor Industries Inc	/etf/ea/ETZCW.djhtm?c=1&etfid=THO.US&back=DON
VOYA	Voya Financial Inc	/etf/ea/ETZCW.djhtm?c=1&etfid=VOYA.US&back=DON
DLB	Dolby Laboratories Inc	/etf/ea/ETZCW.djhtm?c=1&etfid=DLB.US&back=DON
KBR	KBR Inc	/etf/ea/ETZCW.djhtm?c=1&etfid=KBR.US&back=DON
FBHS	Fortune Brands Home & Security	/etf/ea/ETZCW.djhtm?c=1&etfid=FBHS.US&back=DON
SLG	SL Green Realty Corp	/etf/ea/ETZCW.djhtm?c=1&etfid=SLG.US&back=DON
WTFC	Wintrust Financial Corp	/etf/ea/ETZCW.djhtm?c=1&etfid=WTFC.US&back=DON
HIW	Highwoods Properties Inc	/etf/ea/ETZCW.djhtm?c=1&etfid=HIW.US&back=DON
BWXT	BWX Technologies Inc	/etf/ea/ETZCW.djhtm?c=1&etfid=BWXT.US&back=DON
SMG	Scotts Miracle-Gro Co/The	/etf/ea/ETZCW.djhtm?c=1&etfid=SMG.US&back=DON
RYN	Rayonier Inc	/etf/ea/ETZCW.djhtm?c=1&etfid=RYN.US&back=DON
ESI	Element Solutions Inc	/etf/ea/ETZCW.djhtm?c=1&etfid=ESI.US&back=DON
AIRC	Apartment Income Reit Co	/etf/ea/ETZCW.djhtm?c=1&etfid=AIRC.US&back=DON
ATR	Aptargroup Inc	/etf/ea/ETZCW.djhtm?c=1&etfid=ATR.US&back=DON
ADC	Agree Realty Corp	/etf/ea/ETZCW.djhtm?c=1&etfid=ADC.US&back=DON
EGP	EastGroup Properties Inc	/etf/ea/ETZCW.djhtm?c=1&etfid=EGP.US&back=DON
CASY	Casey's General Stores Inc	/etf/ea/ETZCW.djhtm?c=1&etfid=CASY.US&back=DON
SXT	Sensient Technologies Corp	/etf/ea/ETZCW.djhtm?c=1&etfid=SXT.US&back=DON
COLD	Americold Realty Trust	/etf/ea/ETZCW.djhtm?c=1&etfid=COLD.US&back=DON
DOC	Physicians Realty Trust	/etf/ea/ETZCW.djhtm?c=1&etfid=DOC.US&back=DON
SF	Stifel Financial Corp	/etf/ea/ETZCW.djhtm?c=1&etfid=SF.US&back=DON
CRI	Carter's Inc	/etf/ea/ETZCW.djhtm?c=1&etfid=CRI.US&back=DON
MUSA	Murphy USA Inc	/etf/ea/ETZCW.djhtm?c=1&etfid=MUSA.US&back=DON
AGCO	AGCO Corp	/etf/ea/ETZCW.djhtm?c=1&etfid=AGCO.US&back=DON
MSA	MSA Safety Inc	/etf/ea/ETZCW.djhtm?c=1&etfid=MSA.US&back=DON
AA	Alcoa Corp	/etf/ea/ETZCW.djhtm?c=1&etfid=AA.US&back=DON
BNL	Broadstone Net Lease Inc	/etf/ea/ETZCW.djhtm?c=1&etfid=BNL.US&back=DON
AL	Air Lease Corp	/etf/ea/ETZCW.djhtm?c=1&etfid=AL.US&back=DON
GOLF	Acushnet Holdings Corp	/etf/ea/ETZCW.djhtm?c=1&etfid=GOLF.US&back=DON
UFPI	UFP Industries Inc	/etf/ea/ETZCW.djhtm?c=1&etfid=UFPI.US&back=DON
AVNT	Avient Corp	/etf/ea/ETZCW.djhtm?c=1&etfid=AVNT.US&back=DON
ASH	Ashland Global Holdings Inc	/etf/ea/ETZCW.djhtm?c=1&etfid=ASH.US&back=DON
MKTX	MarketAxess Holdings Inc	/etf/ea/ETZCW.djhtm?c=1&etfid=MKTX.US&back=DON
RLI	RLI Corp	/etf/ea/ETZCW.djhtm?c=1&etfid=RLI.US&back=DON
ITT	ITT Inc	/etf/ea/ETZCW.djhtm?c=1&etfid=ITT.US&back=DON
COLM	Columbia Sportswear Co	/etf/ea/ETZCW.djhtm?c=1&etfid=COLM.US&back=DON
VMI	Valmont Industries Inc	/etf/ea/ETZCW.djhtm?c=1&etfid=VMI.US&back=DON
OSK	Oshkosh Corp	/etf/ea/ETZCW.djhtm?c=1&etfid=OSK.US&back=DON
PWR	Quanta Services Inc	/etf/ea/ETZCW.djhtm?c=1&etfid=PWR.US&back=DON
FELE	Franklin Electric Co Inc	/etf/ea/ETZCW.djhtm?c=1&etfid=FELE.US&back=DON
NSA	National Storage Affiliates	/etf/ea/ETZCW.djhtm?c=1&etfid=NSA.US&back=DON
TTEK	Tetra Tech Inc	/etf/ea/ETZCW.djhtm?c=1&etfid=TTEK.US&back=DON
SNX	TD Synnex Corp	/etf/ea/ETZCW.djhtm?c=1&etfid=SNX.US&back=DON
LXP	LXP Industrial Trust	/etf/ea/ETZCW.djhtm?c=1&etfid=LXP.US&back=DON
PNFP	Pinnacle Financial Partners Inc	/etf/ea/ETZCW.djhtm?c=1&etfid=PNFP.US&back=DON
XRAY	Dentsply Sirona Inc	/etf/ea/ETZCW.djhtm?c=1&etfid=XRAY.US&back=DON
SSD	Simpson Manufacturing Co Inc	/etf/ea/ETZCW.djhtm?c=1&etfid=SSD.US&back=DON
JBL	Jabil Inc	/etf/ea/ETZCW.djhtm?c=1&etfid=JBL.US&back=DON
MORN	Morningstar Inc	/etf/ea/ETZCW.djhtm?c=1&etfid=MORN.US&back=DON
REXR	Rexford Industrial Realty Inc	/etf/ea/ETZCW.djhtm?c=1&etfid=REXR.US&back=DON
CNXC	Concentrix Corp	/etf/ea/ETZCW.djhtm?c=1&etfid=CNXC.US&back=DON
TOL	Toll Brothers Inc	/etf/ea/ETZCW.djhtm?c=1&etfid=TOL.US&back=DON
EXPO	Exponent Inc	/etf/ea/ETZCW.djhtm?c=1&etfid=EXPO.US&back=DON
AMKR	Amkor Technology Inc	/etf/ea/ETZCW.djhtm?c=1&etfid=AMKR.US&back=DON
WD	Walker & Dunlop Inc	/etf/ea/ETZCW.djhtm?c=1&etfid=WD.US&back=DON
FR	First Industrial Realty Trust	/etf/ea/ETZCW.djhtm?c=1&etfid=FR.US&back=DON
X	United States Steel Corp	/etf/ea/ETZCW.djhtm?c=1&etfid=X.US&back=DON
TRNO	Terreno Realty Corp	/etf/ea/ETZCW.djhtm?c=1&etfid=TRNO.US&back=DON
SPB	Spectrum Brands Holdings Inc	/etf/ea/ETZCW.djhtm?c=1&etfid=SPB.US&back=DON
LFUS	Littelfuse Inc	/etf/ea/ETZCW.djhtm?c=1&etfid=LFUS.US&back=DON
SFBS	ServisFirst Bancshares Inc	/etf/ea/ETZCW.djhtm?c=1&etfid=SFBS.US&back=DON
AMH	American Homes 4 Rent	/etf/ea/ETZCW.djhtm?c=1&etfid=AMH.US&back=DON
TPX	Tempur Sealy International I	/etf/ea/ETZCW.djhtm?c=1&etfid=TPX.US&back=DON
L	Loews Corp	/etf/ea/ETZCW.djhtm?c=1&etfid=L.US&back=DON
AEO	American Eagle Outfitters Inc	/etf/ea/ETZCW.djhtm?c=1&etfid=AEO.US&back=DON
CHH	Choice Hotels International Inc	/etf/ea/ETZCW.djhtm?c=1&etfid=CHH.US&back=DON
DEI	Douglas Emmett Inc	/etf/ea/ETZCW.djhtm?c=1&etfid=DEI.US&back=DON
WMS	Advanced Drainage Systems Inc	/etf/ea/ETZCW.djhtm?c=1&etfid=WMS.US&back=DON
CUZ	Cousins Properties Inc	/etf/ea/ETZCW.djhtm?c=1&etfid=CUZ.US&back=DON
POWI	Power Integrations Inc	/etf/ea/ETZCW.djhtm?c=1&etfid=POWI.US&back=DON
KNX	Knight-Swift Transportation	/etf/ea/ETZCW.djhtm?c=1&etfid=KNX.US&back=DON
LSTR	Landstar System Inc	/etf/ea/ETZCW.djhtm?c=1&etfid=LSTR.US&back=DON
WMG	Warner Music Group Corp-Cl A	/etf/ea/ETZCW.djhtm?c=1&etfid=WMG.US&back=DON
UHS	Universal Health Services Inc	/etf/ea/ETZCW.djhtm?c=1&etfid=UHS.US&back=DON
MMS	MAXIMUS Inc	/etf/ea/ETZCW.djhtm?c=1&etfid=MMS.US&back=DON
KRG	Kite Realty Group Trust	/etf/ea/ETZCW.djhtm?c=1&etfid=KRG.US&back=DON
HLNE	Hamilton Lane Inc	/etf/ea/ETZCW.djhtm?c=1&etfid=HLNE.US&back=DON
PZZA	Papa John's International Inc	/etf/ea/ETZCW.djhtm?c=1&etfid=PZZA.US&back=DON
MKSI	MKS Instruments Inc	/etf/ea/ETZCW.djhtm?c=1&etfid=MKSI.US&back=DON
AWI	Armstrong World Industries Inc	/etf/ea/ETZCW.djhtm?c=1&etfid=AWI.US&back=DON
LAD	Lithia Motors Inc	/etf/ea/ETZCW.djhtm?c=1&etfid=LAD.US&back=DON
MTDR	Matador Resources Co	/etf/ea/ETZCW.djhtm?c=1&etfid=MTDR.US&back=DON
AMG	Affiliated Managers Group Inc	/etf/ea/ETZCW.djhtm?c=1&etfid=AMG.US&back=DON
EXP	Eagle Materials Inc	/etf/ea/ETZCW.djhtm?c=1&etfid=EXP.US&back=DON
BRKR	Bruker Corp	/etf/ea/ETZCW.djhtm?c=1&etfid=BRKR.US&back=DON
CHDN	Churchill Downs Inc	/etf/ea/ETZCW.djhtm?c=1&etfid=CHDN.US&back=DON
TFX	Teleflex Inc	/etf/ea/ETZCW.djhtm?c=1&etfid=TFX.US&back=DON
TTEC	TTEC Holdings Inc	/etf/ea/ETZCW.djhtm?c=1&etfid=TTEC.US&back=DON
CABO	Cable One Inc	/etf/ea/ETZCW.djhtm?c=1&etfid=CABO.US&back=DON
ORA	Ormat Technologies Inc	/etf/ea/ETZCW.djhtm?c=1&etfid=ORA.US&back=DON
NYT	New York Times Co-A	/etf/ea/ETZCW.djhtm?c=1&etfid=NYT.US&back=DON
HRI	Herc Holdings Inc	/etf/ea/ETZCW.djhtm?c=1&etfid=HRI.US&back=DON
DLN	WisdomTree U.S. LargeCap Dividend Fund	/etf/ea/ETZCW.djhtm?c=1&etfid=DLN.US&back=DON
AAON	AAON Inc	/etf/ea/ETZCW.djhtm?c=1&etfid=AAON.US&back=DON
WTS	Watts Water Technologies Inc	/etf/ea/ETZCW.djhtm?c=1&etfid=WTS.US&back=DON
WWD	Woodward Inc	/etf/ea/ETZCW.djhtm?c=1&etfid=WWD.US&back=DON
IBKR	Interactive Brokers Group Inc	/etf/ea/ETZCW.djhtm?c=1&etfid=IBKR.US&back=DON
CHE	Chemed Corp	/etf/ea/ETZCW.djhtm?c=1&etfid=CHE.US&back=DON
BCPC	Balchem Corp	/etf/ea/ETZCW.djhtm?c=1&etfid=BCPC.US&back=DON
CGNX	Cognex Corp	/etf/ea/ETZCW.djhtm?c=1&etfid=CGNX.US&back=DON
ENSG	Ensign Group Inc/The	/etf/ea/ETZCW.djhtm?c=1&etfid=ENSG.US&back=DON
MAC	Macerich Co/The	/etf/ea/ETZCW.djhtm?c=1&etfid=MAC.US&back=DON
SWCH	Switch Inc - A	/etf/ea/ETZCW.djhtm?c=1&etfid=SWCH.US&back=DON
IIPR	Innovative Industrial Proper	/etf/ea/ETZCW.djhtm?c=1&etfid=IIPR.US&back=DON
ZWS	Zurn Elkay Water Solutions Corp	/etf/ea/ETZCW.djhtm?c=1&etfid=ZWS.US&back=DON
AZTA	AzentaInc.	/etf/ea/ETZCW.djhtm?c=1&etfid=AZTA.US&back=DON
WING	Wingstop Inc	/etf/ea/ETZCW.djhtm?c=1&etfid=WING.US&back=DON
OLED	Universal Display Corp	/etf/ea/ETZCW.djhtm?c=1&etfid=OLED.US&back=DON
CW	Curtiss-Wright Corp	/etf/ea/ETZCW.djhtm?c=1&etfid=CW.US&back=DON
TW	Tradeweb Markets Inc-Class A	/etf/ea/ETZCW.djhtm?c=1&etfid=TW.US&back=DON
BSY	Bentley Systems Inc-Class B	/etf/ea/ETZCW.djhtm?c=1&etfid=BSY.US&back=DON
EME	EMCOR Group Inc	/etf/ea/ETZCW.djhtm?c=1&etfid=EME.US&back=DON
KWR	Quaker Chemical Corp	/etf/ea/ETZCW.djhtm?c=1&etfid=KWR.US&back=DON
SAFE	Safehold Inc	/etf/ea/ETZCW.djhtm?c=1&etfid=SAFE.US&back=DON
SSTK	Shutterstock Inc	/etf/ea/ETZCW.djhtm?c=1&etfid=SSTK.US&back=DON
KFY	Korn Ferry	/etf/ea/ETZCW.djhtm?c=1&etfid=KFY.US&back=DON
KNSL	Kinsale Capital Group Inc	/etf/ea/ETZCW.djhtm?c=1&etfid=KNSL.US&back=DON
DDS	Dillard's Inc	/etf/ea/ETZCW.djhtm?c=1&etfid=DDS.US&back=DON
VNT	Vontier Corp	/etf/ea/ETZCW.djhtm?c=1&etfid=VNT.US&back=DON
COKE	Coca-Cola Consolidated Inc	/etf/ea/ETZCW.djhtm?c=1&etfid=COKE.US&back=DON
SEB	Seaboard Corp	/etf/ea/ETZCW.djhtm?c=1&etfid=SEB.US&back=DON
PEGA	Pegasystems Inc	/etf/ea/ETZCW.djhtm?c=1&etfid=PEGA.US&back=DON
AYI	Acuity Brands Inc	/etf/ea/ETZCW.djhtm?c=1&etfid=AYI.US&back=DON
PVH	PVH Corp	/etf/ea/ETZCW.djhtm?c=1&etfid=PVH.US&back=DON
TXT	Textron Inc	/etf/ea/ETZCW.djhtm?c=1&etfid=TXT.US&back=DON
