ETHO
ARRY	ARRAY TECHNOLOGIES INC	/etf/ea/ETZCW.djhtm?c=1&etfid=ARRY.US&back=ETHO
HRB	BLOCK H & R INC	/etf/ea/ETZCW.djhtm?c=1&etfid=HRB.US&back=ETHO
SHLS	SHOALS TECHNOLOGIES GROUP INC CL A	/etf/ea/ETZCW.djhtm?c=1&etfid=SHLS.US&back=ETHO
FSLR	FIRST SOLAR INC	/etf/ea/ETZCW.djhtm?c=1&etfid=FSLR.US&back=ETHO
ENPH	ENPHASE ENERGY INC	/etf/ea/ETZCW.djhtm?c=1&etfid=ENPH.US&back=ETHO
STEM	STEM INC	/etf/ea/ETZCW.djhtm?c=1&etfid=STEM.US&back=ETHO
LW	LAMB WESTON HLDGS INC	/etf/ea/ETZCW.djhtm?c=1&etfid=LW.US&back=ETHO
	Cash & Other	
ALNY	ALNYLAM PHARMACEUTICALS INC	/etf/ea/ETZCW.djhtm?c=1&etfid=ALNY.US&back=ETHO
FL	FOOT LOCKER INC	/etf/ea/ETZCW.djhtm?c=1&etfid=FL.US&back=ETHO
PAG	PENSKE AUTOMOTIVE GRP INC	/etf/ea/ETZCW.djhtm?c=1&etfid=PAG.US&back=ETHO
AMAL	AMALGAMATED FINANCIAL CORP	/etf/ea/ETZCW.djhtm?c=1&etfid=AMAL.US&back=ETHO
AN	AUTONATION INC	/etf/ea/ETZCW.djhtm?c=1&etfid=AN.US&back=ETHO
GPC	GENUINE PARTS CO	/etf/ea/ETZCW.djhtm?c=1&etfid=GPC.US&back=ETHO
IEA	INFRA AND ENERGY ALTRNTIVE INC COM	/etf/ea/ETZCW.djhtm?c=1&etfid=IEA.US&back=ETHO
LKQ	LKQ CORP	/etf/ea/ETZCW.djhtm?c=1&etfid=LKQ.US&back=ETHO
ATNI	ATN INTL INC	/etf/ea/ETZCW.djhtm?c=1&etfid=ATNI.US&back=ETHO
ORA	ORMAT TECHNOLOGIES INC	/etf/ea/ETZCW.djhtm?c=1&etfid=ORA.US&back=ETHO
TMUS	T-MOBILE US INC	/etf/ea/ETZCW.djhtm?c=1&etfid=TMUS.US&back=ETHO
WMS	ADVANCED DRAIN SYS INC DEL	/etf/ea/ETZCW.djhtm?c=1&etfid=WMS.US&back=ETHO
ON	ON SEMICONDUCTOR CORP	/etf/ea/ETZCW.djhtm?c=1&etfid=ON.US&back=ETHO
SPWR	SUNPOWER CORP	/etf/ea/ETZCW.djhtm?c=1&etfid=SPWR.US&back=ETHO
BR	BROADRIDGE FINL SOLUTIONS INC COM	/etf/ea/ETZCW.djhtm?c=1&etfid=BR.US&back=ETHO
GWW	GRAINGER W W INC	/etf/ea/ETZCW.djhtm?c=1&etfid=GWW.US&back=ETHO
RSG	REPUBLIC SVCS INC	/etf/ea/ETZCW.djhtm?c=1&etfid=RSG.US&back=ETHO
RUN	SUNRUN INC	/etf/ea/ETZCW.djhtm?c=1&etfid=RUN.US&back=ETHO
NSP	INSPERITY INC	/etf/ea/ETZCW.djhtm?c=1&etfid=NSP.US&back=ETHO
NOVA	SUNNOVA ENERGY INTL INC.	/etf/ea/ETZCW.djhtm?c=1&etfid=NOVA.US&back=ETHO
XYL	XYLEM INC	/etf/ea/ETZCW.djhtm?c=1&etfid=XYL.US&back=ETHO
VRTX	VERTEX PHARMACEUTICALS INC	/etf/ea/ETZCW.djhtm?c=1&etfid=VRTX.US&back=ETHO
WM	WASTE MGMT INC DEL	/etf/ea/ETZCW.djhtm?c=1&etfid=WM.US&back=ETHO
GPI	GROUP 1 AUTOMOTIVE INC	/etf/ea/ETZCW.djhtm?c=1&etfid=GPI.US&back=ETHO
CDNS	CADENCE DESIGN SYSTEM INC	/etf/ea/ETZCW.djhtm?c=1&etfid=CDNS.US&back=ETHO
AVY	AVERY DENNISON CORP	/etf/ea/ETZCW.djhtm?c=1&etfid=AVY.US&back=ETHO
AXTA	AXALTA COATING SYS LTD	/etf/ea/ETZCW.djhtm?c=1&etfid=AXTA.US&back=ETHO
CWEN.A	CLEARWAY ENERGY INC	/etf/ea/ETZCW.djhtm?c=1&etfid=CWEN.A.US&back=ETHO
FTV	FORTIVE CORP	/etf/ea/ETZCW.djhtm?c=1&etfid=FTV.US&back=ETHO
KEYS	KEYSIGHT TECHNOLOGIES INC	/etf/ea/ETZCW.djhtm?c=1&etfid=KEYS.US&back=ETHO
WSM	WILLIAMS SONOMA INC	/etf/ea/ETZCW.djhtm?c=1&etfid=WSM.US&back=ETHO
TJX	TJX COS INC NEW	/etf/ea/ETZCW.djhtm?c=1&etfid=TJX.US&back=ETHO
MRK	MERCK & CO INC	/etf/ea/ETZCW.djhtm?c=1&etfid=MRK.US&back=ETHO
MSI	MOTOROLA SOLUTIONS INC	/etf/ea/ETZCW.djhtm?c=1&etfid=MSI.US&back=ETHO
MOH	MOLINA HEALTHCARE INC	/etf/ea/ETZCW.djhtm?c=1&etfid=MOH.US&back=ETHO
PAYC	PAYCOM SOFTWARE INC	/etf/ea/ETZCW.djhtm?c=1&etfid=PAYC.US&back=ETHO
SYY	SYSCO CORP	/etf/ea/ETZCW.djhtm?c=1&etfid=SYY.US&back=ETHO
WCC	WESCO INTL INC	/etf/ea/ETZCW.djhtm?c=1&etfid=WCC.US&back=ETHO
FCPT	FOUR CORNERS PPTY TR INC	/etf/ea/ETZCW.djhtm?c=1&etfid=FCPT.US&back=ETHO
CRMT	AMERICAS CAR-MART INC	/etf/ea/ETZCW.djhtm?c=1&etfid=CRMT.US&back=ETHO
CMG	CHIPOTLE MEXICAN GRILL INC	/etf/ea/ETZCW.djhtm?c=1&etfid=CMG.US&back=ETHO
BLD	TOPBUILD CORP	/etf/ea/ETZCW.djhtm?c=1&etfid=BLD.US&back=ETHO
CWT	CALIFORNIA WTR SVC GROUP	/etf/ea/ETZCW.djhtm?c=1&etfid=CWT.US&back=ETHO
AMN	AMN HEALTHCARE SVCS INC	/etf/ea/ETZCW.djhtm?c=1&etfid=AMN.US&back=ETHO
FISV	FISERV INC	/etf/ea/ETZCW.djhtm?c=1&etfid=FISV.US&back=ETHO
JKHY	HENRY JACK & ASSOC INC	/etf/ea/ETZCW.djhtm?c=1&etfid=JKHY.US&back=ETHO
WCN	WASTE CONNECTIONS INC	/etf/ea/ETZCW.djhtm?c=1&etfid=WCN.US&back=ETHO
WAFD	WASHINGTON FED INC	/etf/ea/ETZCW.djhtm?c=1&etfid=WAFD.US&back=ETHO
WTS	WATTS WATER TECHNOLOGIES INC CL A	/etf/ea/ETZCW.djhtm?c=1&etfid=WTS.US&back=ETHO
WRB	BERKLEY W R CORP	/etf/ea/ETZCW.djhtm?c=1&etfid=WRB.US&back=ETHO
PLUG	PLUG POWER INC	/etf/ea/ETZCW.djhtm?c=1&etfid=PLUG.US&back=ETHO
NATI	NATIONAL INSTRS CORP	/etf/ea/ETZCW.djhtm?c=1&etfid=NATI.US&back=ETHO
LSTR	LANDSTAR SYS INC	/etf/ea/ETZCW.djhtm?c=1&etfid=LSTR.US&back=ETHO
SSB	SOUTHSTATE CORPORATION	/etf/ea/ETZCW.djhtm?c=1&etfid=SSB.US&back=ETHO
ROL	ROLLINS INC	/etf/ea/ETZCW.djhtm?c=1&etfid=ROL.US&back=ETHO
ROST	ROSS STORES INC	/etf/ea/ETZCW.djhtm?c=1&etfid=ROST.US&back=ETHO
WAT	WATERS CORP	/etf/ea/ETZCW.djhtm?c=1&etfid=WAT.US&back=ETHO
TGNA	TEGNA INC	/etf/ea/ETZCW.djhtm?c=1&etfid=TGNA.US&back=ETHO
LOW	LOWES COS INC	/etf/ea/ETZCW.djhtm?c=1&etfid=LOW.US&back=ETHO
LFUS	LITTELFUSE INC	/etf/ea/ETZCW.djhtm?c=1&etfid=LFUS.US&back=ETHO
IT	GARTNER INC	/etf/ea/ETZCW.djhtm?c=1&etfid=IT.US&back=ETHO
FHN	FIRST HORIZON CORPORATION	/etf/ea/ETZCW.djhtm?c=1&etfid=FHN.US&back=ETHO
GL	GLOBE LIFE INC	/etf/ea/ETZCW.djhtm?c=1&etfid=GL.US&back=ETHO
HAS	HASBRO INC	/etf/ea/ETZCW.djhtm?c=1&etfid=HAS.US&back=ETHO
CTAS	CINTAS CORP	/etf/ea/ETZCW.djhtm?c=1&etfid=CTAS.US&back=ETHO
CPRT	COPART INC	/etf/ea/ETZCW.djhtm?c=1&etfid=CPRT.US&back=ETHO
DHI	D R HORTON INC	/etf/ea/ETZCW.djhtm?c=1&etfid=DHI.US&back=ETHO
BMI	BADGER METER INC	/etf/ea/ETZCW.djhtm?c=1&etfid=BMI.US&back=ETHO
CBSH	COMMERCE BANCSHARES INC	/etf/ea/ETZCW.djhtm?c=1&etfid=CBSH.US&back=ETHO
CDW	CDW CORP	/etf/ea/ETZCW.djhtm?c=1&etfid=CDW.US&back=ETHO
CFR	CULLEN FROST BANKERS INC	/etf/ea/ETZCW.djhtm?c=1&etfid=CFR.US&back=ETHO
BMY	BRISTOL-MYERS SQUIBB CO	/etf/ea/ETZCW.djhtm?c=1&etfid=BMY.US&back=ETHO
BOH	BANK HAWAII CORP	/etf/ea/ETZCW.djhtm?c=1&etfid=BOH.US&back=ETHO
DLB	DOLBY LABORATORIES INC	/etf/ea/ETZCW.djhtm?c=1&etfid=DLB.US&back=ETHO
ADSK	AUTODESK INC	/etf/ea/ETZCW.djhtm?c=1&etfid=ADSK.US&back=ETHO
BEN	FRANKLIN RESOURCES INC	/etf/ea/ETZCW.djhtm?c=1&etfid=BEN.US&back=ETHO
AWI	ARMSTRONG WORLD INDS INC NEW COM	/etf/ea/ETZCW.djhtm?c=1&etfid=AWI.US&back=ETHO
AWR	AMER STATES WTR CO	/etf/ea/ETZCW.djhtm?c=1&etfid=AWR.US&back=ETHO
GNTX	GENTEX CORP	/etf/ea/ETZCW.djhtm?c=1&etfid=GNTX.US&back=ETHO
EL	LAUDER ESTEE COS INC	/etf/ea/ETZCW.djhtm?c=1&etfid=EL.US&back=ETHO
ITW	ILLINOIS TOOL WKS INC	/etf/ea/ETZCW.djhtm?c=1&etfid=ITW.US&back=ETHO
IBKR	INTERACTIVE BROKERS GROUP INC COM CL A	/etf/ea/ETZCW.djhtm?c=1&etfid=IBKR.US&back=ETHO
LII	LENNOX INTL INC	/etf/ea/ETZCW.djhtm?c=1&etfid=LII.US&back=ETHO
KLAC	KLA CORP	/etf/ea/ETZCW.djhtm?c=1&etfid=KLAC.US&back=ETHO
TPR	TAPESTRY INC	/etf/ea/ETZCW.djhtm?c=1&etfid=TPR.US&back=ETHO
VOYA	VOYA FINANCIAL INC	/etf/ea/ETZCW.djhtm?c=1&etfid=VOYA.US&back=ETHO
SBAC	SBA COMMUNICATIONS CORP NEW	/etf/ea/ETZCW.djhtm?c=1&etfid=SBAC.US&back=ETHO
SCI	SERVICE CORP INTL	/etf/ea/ETZCW.djhtm?c=1&etfid=SCI.US&back=ETHO
SCS	STEELCASE INC	/etf/ea/ETZCW.djhtm?c=1&etfid=SCS.US&back=ETHO
MSM	MSC INDL DIRECT INC	/etf/ea/ETZCW.djhtm?c=1&etfid=MSM.US&back=ETHO
NVR	NVR INC	/etf/ea/ETZCW.djhtm?c=1&etfid=NVR.US&back=ETHO
NYCB	NEW YORK CMNTY BANCORP INC	/etf/ea/ETZCW.djhtm?c=1&etfid=NYCB.US&back=ETHO
ODFL	OLD DOMINION FREIGHT LINE INC COM	/etf/ea/ETZCW.djhtm?c=1&etfid=ODFL.US&back=ETHO
PAYX	PAYCHEX INC	/etf/ea/ETZCW.djhtm?c=1&etfid=PAYX.US&back=ETHO
MET	METLIFE INC	/etf/ea/ETZCW.djhtm?c=1&etfid=MET.US&back=ETHO
RMD	RESMED INC	/etf/ea/ETZCW.djhtm?c=1&etfid=RMD.US&back=ETHO
UPS	UNITED PARCEL SERVICE INC	/etf/ea/ETZCW.djhtm?c=1&etfid=UPS.US&back=ETHO
VMC	VULCAN MATLS CO	/etf/ea/ETZCW.djhtm?c=1&etfid=VMC.US&back=ETHO
WAB	WABTEC	/etf/ea/ETZCW.djhtm?c=1&etfid=WAB.US&back=ETHO
TXN	TEXAS INSTRS INC	/etf/ea/ETZCW.djhtm?c=1&etfid=TXN.US&back=ETHO
IQV	IQVIA HLDGS INC	/etf/ea/ETZCW.djhtm?c=1&etfid=IQV.US&back=ETHO
MA	MASTERCARD INCORPORATED	/etf/ea/ETZCW.djhtm?c=1&etfid=MA.US&back=ETHO
FWONK	LIBERTY MEDIA CORP DEL	/etf/ea/ETZCW.djhtm?c=1&etfid=FWONK.US&back=ETHO
ITRI	ITRON INC	/etf/ea/ETZCW.djhtm?c=1&etfid=ITRI.US&back=ETHO
FIS	FIDELITY NATL INFORMATION SVCS COM	/etf/ea/ETZCW.djhtm?c=1&etfid=FIS.US&back=ETHO
GPN	GLOBAL PMTS INC	/etf/ea/ETZCW.djhtm?c=1&etfid=GPN.US&back=ETHO
AMG	AFFILIATED MANAGERS GROUP INC COM	/etf/ea/ETZCW.djhtm?c=1&etfid=AMG.US&back=ETHO
ADI	ANALOG DEVICES INC	/etf/ea/ETZCW.djhtm?c=1&etfid=ADI.US&back=ETHO
DHR	DANAHER CORPORATION	/etf/ea/ETZCW.djhtm?c=1&etfid=DHR.US&back=ETHO
DFS	DISCOVER FINL SVCS	/etf/ea/ETZCW.djhtm?c=1&etfid=DFS.US&back=ETHO
DGX	QUEST DIAGNOSTICS INC	/etf/ea/ETZCW.djhtm?c=1&etfid=DGX.US&back=ETHO
ARES	ARES MANAGEMENT CORPORATION	/etf/ea/ETZCW.djhtm?c=1&etfid=ARES.US&back=ETHO
CNNE	CANNAE HLDGS INC	/etf/ea/ETZCW.djhtm?c=1&etfid=CNNE.US&back=ETHO
CIA	CITIZENS INC	/etf/ea/ETZCW.djhtm?c=1&etfid=CIA.US&back=ETHO
DE	DEERE & CO	/etf/ea/ETZCW.djhtm?c=1&etfid=DE.US&back=ETHO
AAPL	APPLE INC	/etf/ea/ETZCW.djhtm?c=1&etfid=AAPL.US&back=ETHO
AWK	AMERICAN WTR WKS CO INC NEW	/etf/ea/ETZCW.djhtm?c=1&etfid=AWK.US&back=ETHO
ATR	APTARGROUP INC	/etf/ea/ETZCW.djhtm?c=1&etfid=ATR.US&back=ETHO
AOS	SMITH A O CORP	/etf/ea/ETZCW.djhtm?c=1&etfid=AOS.US&back=ETHO
HIG	HARTFORD FINL SVCS GROUP INC COM	/etf/ea/ETZCW.djhtm?c=1&etfid=HIG.US&back=ETHO
EVA	ENVIVA INC	/etf/ea/ETZCW.djhtm?c=1&etfid=EVA.US&back=ETHO
INTU	INTUIT	/etf/ea/ETZCW.djhtm?c=1&etfid=INTU.US&back=ETHO
TPX	TEMPUR SEALY INTERNATIONAL INC	/etf/ea/ETZCW.djhtm?c=1&etfid=TPX.US&back=ETHO
UHAL	AMERCO	/etf/ea/ETZCW.djhtm?c=1&etfid=UHAL.US&back=ETHO
V	VISA INC	/etf/ea/ETZCW.djhtm?c=1&etfid=V.US&back=ETHO
PFE	PFIZER INC	/etf/ea/ETZCW.djhtm?c=1&etfid=PFE.US&back=ETHO
PKG	PACKAGING CORP AMER	/etf/ea/ETZCW.djhtm?c=1&etfid=PKG.US&back=ETHO
MSCI	MSCI INC	/etf/ea/ETZCW.djhtm?c=1&etfid=MSCI.US&back=ETHO
MTD	METTLER TOLEDO INTERNATIONAL COM	/etf/ea/ETZCW.djhtm?c=1&etfid=MTD.US&back=ETHO
PDCO	PATTERSON COS INC	/etf/ea/ETZCW.djhtm?c=1&etfid=PDCO.US&back=ETHO
NTAP	NETAPP INC	/etf/ea/ETZCW.djhtm?c=1&etfid=NTAP.US&back=ETHO
PSA	PUBLIC STORAGE	/etf/ea/ETZCW.djhtm?c=1&etfid=PSA.US&back=ETHO
QCOM	QUALCOMM INC	/etf/ea/ETZCW.djhtm?c=1&etfid=QCOM.US&back=ETHO
REG	REGENCY CTRS CORP	/etf/ea/ETZCW.djhtm?c=1&etfid=REG.US&back=ETHO
VRSK	VERISK ANALYTICS INC	/etf/ea/ETZCW.djhtm?c=1&etfid=VRSK.US&back=ETHO
TFSL	TFS FINL CORP	/etf/ea/ETZCW.djhtm?c=1&etfid=TFSL.US&back=ETHO
TRMB	TRIMBLE INC	/etf/ea/ETZCW.djhtm?c=1&etfid=TRMB.US&back=ETHO
WLY	WILEY JOHN & SONS INC	/etf/ea/ETZCW.djhtm?c=1&etfid=WLY.US&back=ETHO
JBHT	HUNT J B TRANS SVCS INC	/etf/ea/ETZCW.djhtm?c=1&etfid=JBHT.US&back=ETHO
MAR	MARRIOTT INTL INC NEW	/etf/ea/ETZCW.djhtm?c=1&etfid=MAR.US&back=ETHO
KIM	KIMCO RLTY CORP	/etf/ea/ETZCW.djhtm?c=1&etfid=KIM.US&back=ETHO
APOG	APOGEE ENTERPRISES INC	/etf/ea/ETZCW.djhtm?c=1&etfid=APOG.US&back=ETHO
ANET	ARISTA NETWORKS INC	/etf/ea/ETZCW.djhtm?c=1&etfid=ANET.US&back=ETHO
BIO	BIO RAD LABS INC	/etf/ea/ETZCW.djhtm?c=1&etfid=BIO.US&back=ETHO
AGIO	AGIOS PHARMACEUTICALS INC	/etf/ea/ETZCW.djhtm?c=1&etfid=AGIO.US&back=ETHO
AMRC	AMERESCO INC	/etf/ea/ETZCW.djhtm?c=1&etfid=AMRC.US&back=ETHO
CFFN	CAPITOL FED FINL INC	/etf/ea/ETZCW.djhtm?c=1&etfid=CFFN.US&back=ETHO
CHD	CHURCH & DWIGHT CO INC	/etf/ea/ETZCW.djhtm?c=1&etfid=CHD.US&back=ETHO
CIEN	CIENA CORP	/etf/ea/ETZCW.djhtm?c=1&etfid=CIEN.US&back=ETHO
HSIC	HENRY SCHEIN INC	/etf/ea/ETZCW.djhtm?c=1&etfid=HSIC.US&back=ETHO
FAST	FASTENAL CO	/etf/ea/ETZCW.djhtm?c=1&etfid=FAST.US&back=ETHO
HLT	HILTON WORLDWIDE HLDGS INC	/etf/ea/ETZCW.djhtm?c=1&etfid=HLT.US&back=ETHO
HASI	HANNON ARMSTRONG SUST INFR CAP COM	/etf/ea/ETZCW.djhtm?c=1&etfid=HASI.US&back=ETHO
WDC	WESTERN DIGITAL CORP.	/etf/ea/ETZCW.djhtm?c=1&etfid=WDC.US&back=ETHO
ZTS	ZOETIS INC	/etf/ea/ETZCW.djhtm?c=1&etfid=ZTS.US&back=ETHO
TYL	TYLER TECHNOLOGIES INC	/etf/ea/ETZCW.djhtm?c=1&etfid=TYL.US&back=ETHO
TFC	TRUIST FINANCIAL CORP	/etf/ea/ETZCW.djhtm?c=1&etfid=TFC.US&back=ETHO
STE	STERIS PLC	/etf/ea/ETZCW.djhtm?c=1&etfid=STE.US&back=ETHO
SCHW	SCHWAB CHARLES CORP	/etf/ea/ETZCW.djhtm?c=1&etfid=SCHW.US&back=ETHO
ROK	ROCKWELL AUTOMATION INC	/etf/ea/ETZCW.djhtm?c=1&etfid=ROK.US&back=ETHO
MSEX	MIDDLESEX WTR CO	/etf/ea/ETZCW.djhtm?c=1&etfid=MSEX.US&back=ETHO
MSFT	MICROSOFT CORP	/etf/ea/ETZCW.djhtm?c=1&etfid=MSFT.US&back=ETHO
MKC	MCCORMICK & CO INC	/etf/ea/ETZCW.djhtm?c=1&etfid=MKC.US&back=ETHO
NTRS	NORTHERN TR CORP	/etf/ea/ETZCW.djhtm?c=1&etfid=NTRS.US&back=ETHO
PYPL	PAYPAL HLDGS INC	/etf/ea/ETZCW.djhtm?c=1&etfid=PYPL.US&back=ETHO
RL	RALPH LAUREN CORP	/etf/ea/ETZCW.djhtm?c=1&etfid=RL.US&back=ETHO
RMBS	RAMBUS INC DEL	/etf/ea/ETZCW.djhtm?c=1&etfid=RMBS.US&back=ETHO
VRSN	VERISIGN INC	/etf/ea/ETZCW.djhtm?c=1&etfid=VRSN.US&back=ETHO
URI	UNITED RENTALS INC	/etf/ea/ETZCW.djhtm?c=1&etfid=URI.US&back=ETHO
VZ	VERIZON COMMUNICATIONS INC	/etf/ea/ETZCW.djhtm?c=1&etfid=VZ.US&back=ETHO
HPE	HEWLETT PACKARD ENTERPRISE CO COM	/etf/ea/ETZCW.djhtm?c=1&etfid=HPE.US&back=ETHO
FBHS	FORTUNE BRANDS HOME & SEC INC COM	/etf/ea/ETZCW.djhtm?c=1&etfid=FBHS.US&back=ETHO
IPGP	IPG PHOTONICS CORP	/etf/ea/ETZCW.djhtm?c=1&etfid=IPGP.US&back=ETHO
LRCX	LAM RESEARCH CORP	/etf/ea/ETZCW.djhtm?c=1&etfid=LRCX.US&back=ETHO
CHPT	CHARGEPOINT HOLDINGS INC	/etf/ea/ETZCW.djhtm?c=1&etfid=CHPT.US&back=ETHO
BLNK	BLINK CHARGING CO	/etf/ea/ETZCW.djhtm?c=1&etfid=BLNK.US&back=ETHO
DIS	DISNEY WALT CO	/etf/ea/ETZCW.djhtm?c=1&etfid=DIS.US&back=ETHO
CSCO	CISCO SYS INC	/etf/ea/ETZCW.djhtm?c=1&etfid=CSCO.US&back=ETHO
AAP	ADVANCE AUTO PARTS INC	/etf/ea/ETZCW.djhtm?c=1&etfid=AAP.US&back=ETHO
ADBE	ADOBE SYSTEMS INCORPORATED	/etf/ea/ETZCW.djhtm?c=1&etfid=ADBE.US&back=ETHO
AXP	AMERICAN EXPRESS CO	/etf/ea/ETZCW.djhtm?c=1&etfid=AXP.US&back=ETHO
AVB	AVALONBAY CMNTYS INC	/etf/ea/ETZCW.djhtm?c=1&etfid=AVB.US&back=ETHO
AVGO	BROADCOM INC	/etf/ea/ETZCW.djhtm?c=1&etfid=AVGO.US&back=ETHO
BKNG	BOOKING HOLDINGS INC	/etf/ea/ETZCW.djhtm?c=1&etfid=BKNG.US&back=ETHO
BBY	BEST BUY INC	/etf/ea/ETZCW.djhtm?c=1&etfid=BBY.US&back=ETHO
ABMD	ABIOMED INC	/etf/ea/ETZCW.djhtm?c=1&etfid=ABMD.US&back=ETHO
IPG	INTERPUBLIC GROUP COS INC	/etf/ea/ETZCW.djhtm?c=1&etfid=IPG.US&back=ETHO
HYLN	HYLIION HOLDINGS CORP	/etf/ea/ETZCW.djhtm?c=1&etfid=HYLN.US&back=ETHO
UDR	UDR INC	/etf/ea/ETZCW.djhtm?c=1&etfid=UDR.US&back=ETHO
TROW	PRICE T ROWE GROUP INC	/etf/ea/ETZCW.djhtm?c=1&etfid=TROW.US&back=ETHO
TSCO	TRACTOR SUPPLY CO	/etf/ea/ETZCW.djhtm?c=1&etfid=TSCO.US&back=ETHO
PSMT	PRICESMART INC	/etf/ea/ETZCW.djhtm?c=1&etfid=PSMT.US&back=ETHO
PTRA	PROTERRA INC	/etf/ea/ETZCW.djhtm?c=1&etfid=PTRA.US&back=ETHO
MLKN	MILLERKNOLL INC	/etf/ea/ETZCW.djhtm?c=1&etfid=MLKN.US&back=ETHO
NCR	NCR CORP NEW	/etf/ea/ETZCW.djhtm?c=1&etfid=NCR.US&back=ETHO
NOW	SERVICENOW INC	/etf/ea/ETZCW.djhtm?c=1&etfid=NOW.US&back=ETHO
PLD	PROLOGIS INC.	/etf/ea/ETZCW.djhtm?c=1&etfid=PLD.US&back=ETHO
POWI	POWER INTEGRATIONS INC	/etf/ea/ETZCW.djhtm?c=1&etfid=POWI.US&back=ETHO
TSLA	TESLA INC	/etf/ea/ETZCW.djhtm?c=1&etfid=TSLA.US&back=ETHO
TECH	BIO-TECHNE CORP	/etf/ea/ETZCW.djhtm?c=1&etfid=TECH.US&back=ETHO
MBI	MBIA INC	/etf/ea/ETZCW.djhtm?c=1&etfid=MBI.US&back=ETHO
LYV	LIVE NATION ENTERTAINMENT INC COM	/etf/ea/ETZCW.djhtm?c=1&etfid=LYV.US&back=ETHO
JNPR	JUNIPER NETWORKS INC	/etf/ea/ETZCW.djhtm?c=1&etfid=JNPR.US&back=ETHO
EW	EDWARDS LIFESCIENCES CORP	/etf/ea/ETZCW.djhtm?c=1&etfid=EW.US&back=ETHO
GOOGL	ALPHABET INC	/etf/ea/ETZCW.djhtm?c=1&etfid=GOOGL.US&back=ETHO
AMZN	AMAZON COM INC	/etf/ea/ETZCW.djhtm?c=1&etfid=AMZN.US&back=ETHO
AMD	ADVANCED MICRO DEVICES INC	/etf/ea/ETZCW.djhtm?c=1&etfid=AMD.US&back=ETHO
ALLY	ALLY FINL INC	/etf/ea/ETZCW.djhtm?c=1&etfid=ALLY.US&back=ETHO
ANSS	ANSYS INC	/etf/ea/ETZCW.djhtm?c=1&etfid=ANSS.US&back=ETHO
CPT	CAMDEN PPTY TR	/etf/ea/ETZCW.djhtm?c=1&etfid=CPT.US&back=ETHO
EBAY	EBAY INC.	/etf/ea/ETZCW.djhtm?c=1&etfid=EBAY.US&back=ETHO
CRM	SALESFORCE INC	/etf/ea/ETZCW.djhtm?c=1&etfid=CRM.US&back=ETHO
AKAM	AKAMAI TECHNOLOGIES INC	/etf/ea/ETZCW.djhtm?c=1&etfid=AKAM.US&back=ETHO
EVGO	EVGO INC	/etf/ea/ETZCW.djhtm?c=1&etfid=EVGO.US&back=ETHO
FFIV	F5 INC	/etf/ea/ETZCW.djhtm?c=1&etfid=FFIV.US&back=ETHO
LBRDK	LIBERTY BROADBAND CORP	/etf/ea/ETZCW.djhtm?c=1&etfid=LBRDK.US&back=ETHO
VFC	V F CORP	/etf/ea/ETZCW.djhtm?c=1&etfid=VFC.US&back=ETHO
PVH	PVH CORPORATION	/etf/ea/ETZCW.djhtm?c=1&etfid=PVH.US&back=ETHO
QRVO	QORVO INC	/etf/ea/ETZCW.djhtm?c=1&etfid=QRVO.US&back=ETHO
SIVB	SVB FINANCIAL GROUP	/etf/ea/ETZCW.djhtm?c=1&etfid=SIVB.US&back=ETHO
MU	MICRON TECHNOLOGY INC	/etf/ea/ETZCW.djhtm?c=1&etfid=MU.US&back=ETHO
MKTX	MARKETAXESS HLDGS INC	/etf/ea/ETZCW.djhtm?c=1&etfid=MKTX.US&back=ETHO
TER	TERADYNE INC	/etf/ea/ETZCW.djhtm?c=1&etfid=TER.US&back=ETHO
TREX	TREX CO INC	/etf/ea/ETZCW.djhtm?c=1&etfid=TREX.US&back=ETHO
ZBRA	ZEBRA TECHNOLOGIES CORPORATION CL A	/etf/ea/ETZCW.djhtm?c=1&etfid=ZBRA.US&back=ETHO
WST	WEST PHARMACEUTICAL SVSC INC COM	/etf/ea/ETZCW.djhtm?c=1&etfid=WST.US&back=ETHO
FCEL	FUELCELL ENERGY INC	/etf/ea/ETZCW.djhtm?c=1&etfid=FCEL.US&back=ETHO
FTNT	FORTINET INC	/etf/ea/ETZCW.djhtm?c=1&etfid=FTNT.US&back=ETHO
AMAT	APPLIED MATLS INC	/etf/ea/ETZCW.djhtm?c=1&etfid=AMAT.US&back=ETHO
CINF	CINCINNATI FINL CORP	/etf/ea/ETZCW.djhtm?c=1&etfid=CINF.US&back=ETHO
COO	COOPER COS INC	/etf/ea/ETZCW.djhtm?c=1&etfid=COO.US&back=ETHO
VLTA	VOLTA INC	/etf/ea/ETZCW.djhtm?c=1&etfid=VLTA.US&back=ETHO
WDAY	WORKDAY INC	/etf/ea/ETZCW.djhtm?c=1&etfid=WDAY.US&back=ETHO
ZM	ZOOM VIDEO COMMUNICATIONS INC CL A	/etf/ea/ETZCW.djhtm?c=1&etfid=ZM.US&back=ETHO
OLED	UNIVERSAL DISPLAY CORP	/etf/ea/ETZCW.djhtm?c=1&etfid=OLED.US&back=ETHO
NYT	NEW YORK TIMES CO	/etf/ea/ETZCW.djhtm?c=1&etfid=NYT.US&back=ETHO
RHI	ROBERT HALF INTL INC	/etf/ea/ETZCW.djhtm?c=1&etfid=RHI.US&back=ETHO
AEO	AMERICAN EAGLE OUTFITTERS INC COM	/etf/ea/ETZCW.djhtm?c=1&etfid=AEO.US&back=ETHO
HRI	HERC HLDGS INC	/etf/ea/ETZCW.djhtm?c=1&etfid=HRI.US&back=ETHO
LAND	GLADSTONE LD CORP	/etf/ea/ETZCW.djhtm?c=1&etfid=LAND.US&back=ETHO
IAC	IAC INC	/etf/ea/ETZCW.djhtm?c=1&etfid=IAC.US&back=ETHO
INTC	INTEL CORP	/etf/ea/ETZCW.djhtm?c=1&etfid=INTC.US&back=ETHO
DXCM	DEXCOM INC	/etf/ea/ETZCW.djhtm?c=1&etfid=DXCM.US&back=ETHO
TFX	TELEFLEX INCORPORATED	/etf/ea/ETZCW.djhtm?c=1&etfid=TFX.US&back=ETHO
IDXX	IDEXX LABS INC	/etf/ea/ETZCW.djhtm?c=1&etfid=IDXX.US&back=ETHO
HBI	HANESBRANDS INC	/etf/ea/ETZCW.djhtm?c=1&etfid=HBI.US&back=ETHO
DDD	3-D SYS CORP DEL	/etf/ea/ETZCW.djhtm?c=1&etfid=DDD.US&back=ETHO
NFLX	NETFLIX INC	/etf/ea/ETZCW.djhtm?c=1&etfid=NFLX.US&back=ETHO
PBI	PITNEY BOWES INC	/etf/ea/ETZCW.djhtm?c=1&etfid=PBI.US&back=ETHO
HAIN	HAIN CELESTIAL GROUP INC	/etf/ea/ETZCW.djhtm?c=1&etfid=HAIN.US&back=ETHO
ILMN	ILLUMINA INC	/etf/ea/ETZCW.djhtm?c=1&etfid=ILMN.US&back=ETHO
ALGN	ALIGN TECHNOLOGY INC	/etf/ea/ETZCW.djhtm?c=1&etfid=ALGN.US&back=ETHO
NVDA	NVIDIA CORPORATION	/etf/ea/ETZCW.djhtm?c=1&etfid=NVDA.US&back=ETHO
QS	QUANTUMSCAPE CORP	/etf/ea/ETZCW.djhtm?c=1&etfid=QS.US&back=ETHO
XL	XL FLEET CORP	/etf/ea/ETZCW.djhtm?c=1&etfid=XL.US&back=ETHO
EXPE	EXPEDIA GROUP INC	/etf/ea/ETZCW.djhtm?c=1&etfid=EXPE.US&back=ETHO
BYND	BEYOND MEAT INC	/etf/ea/ETZCW.djhtm?c=1&etfid=BYND.US&back=ETHO
ZEV	LIGHTNING EMOTORS INC	/etf/ea/ETZCW.djhtm?c=1&etfid=ZEV.US&back=ETHO
EOSE	EOS ENERGY ENTERPRISES INC	/etf/ea/ETZCW.djhtm?c=1&etfid=EOSE.US&back=ETHO
FOSL	FOSSIL GROUP INC	/etf/ea/ETZCW.djhtm?c=1&etfid=FOSL.US&back=ETHO
TDOC	TELADOC HEALTH INC	/etf/ea/ETZCW.djhtm?c=1&etfid=TDOC.US&back=ETHO
RMO	ROMEO POWER INC	/etf/ea/ETZCW.djhtm?c=1&etfid=RMO.US&back=ETHO
MVST	MICROVAST HOLDINGS INC	/etf/ea/ETZCW.djhtm?c=1&etfid=MVST.US&back=ETHO
FUV	ARCIMOTO INC	/etf/ea/ETZCW.djhtm?c=1&etfid=FUV.US&back=ETHO
HYZN	HYZON MOTORS INC	/etf/ea/ETZCW.djhtm?c=1&etfid=HYZN.US&back=ETHO
