EWRE
MAA	Mid-America Apartment Communities Inc	/etf/ea/ETZCW.djhtm?c=1&etfid=MAA.US&back=EWRE
CPT	Camden Property Trust	/etf/ea/ETZCW.djhtm?c=1&etfid=CPT.US&back=EWRE
VICI	VICI Properties Inc	/etf/ea/ETZCW.djhtm?c=1&etfid=VICI.US&back=EWRE
ARE	Alexandria Real Estate Equities Inc	/etf/ea/ETZCW.djhtm?c=1&etfid=ARE.US&back=EWRE
BXP	Boston Properties Inc	/etf/ea/ETZCW.djhtm?c=1&etfid=BXP.US&back=EWRE
O	Realty Income Corp	/etf/ea/ETZCW.djhtm?c=1&etfid=O.US&back=EWRE
EQR	Equity Residential	/etf/ea/ETZCW.djhtm?c=1&etfid=EQR.US&back=EWRE
ESS	Essex Property Trust Inc	/etf/ea/ETZCW.djhtm?c=1&etfid=ESS.US&back=EWRE
HST	Host Hotels & Resorts Inc	/etf/ea/ETZCW.djhtm?c=1&etfid=HST.US&back=EWRE
UDR	UDR Inc	/etf/ea/ETZCW.djhtm?c=1&etfid=UDR.US&back=EWRE
FRT	Federal Realty Investment Trust	/etf/ea/ETZCW.djhtm?c=1&etfid=FRT.US&back=EWRE
SPG	Simon Property Group Inc	/etf/ea/ETZCW.djhtm?c=1&etfid=SPG.US&back=EWRE
REG	Regency Centers Corp	/etf/ea/ETZCW.djhtm?c=1&etfid=REG.US&back=EWRE
EQIX	Equinix Inc	/etf/ea/ETZCW.djhtm?c=1&etfid=EQIX.US&back=EWRE
PSA	Public Storage	/etf/ea/ETZCW.djhtm?c=1&etfid=PSA.US&back=EWRE
SBAC	SBA Communications Corp	/etf/ea/ETZCW.djhtm?c=1&etfid=SBAC.US&back=EWRE
AVB	AvalonBay Communities Inc	/etf/ea/ETZCW.djhtm?c=1&etfid=AVB.US&back=EWRE
EXR	Extra Space Storage Inc	/etf/ea/ETZCW.djhtm?c=1&etfid=EXR.US&back=EWRE
INVH	Invitation Homes Inc	/etf/ea/ETZCW.djhtm?c=1&etfid=INVH.US&back=EWRE
PEAK	Healthpeak Properties Inc	/etf/ea/ETZCW.djhtm?c=1&etfid=PEAK.US&back=EWRE
KIM	Kimco Realty Corp	/etf/ea/ETZCW.djhtm?c=1&etfid=KIM.US&back=EWRE
VNO	Vornado Realty Trust	/etf/ea/ETZCW.djhtm?c=1&etfid=VNO.US&back=EWRE
CBRE	CBRE Group Inc	/etf/ea/ETZCW.djhtm?c=1&etfid=CBRE.US&back=EWRE
WELL	Welltower Inc	/etf/ea/ETZCW.djhtm?c=1&etfid=WELL.US&back=EWRE
CCI	Crown Castle Inc	/etf/ea/ETZCW.djhtm?c=1&etfid=CCI.US&back=EWRE
WY	Weyerhaeuser Co	/etf/ea/ETZCW.djhtm?c=1&etfid=WY.US&back=EWRE
AMT	American Tower Corp	/etf/ea/ETZCW.djhtm?c=1&etfid=AMT.US&back=EWRE
VTR	Ventas Inc	/etf/ea/ETZCW.djhtm?c=1&etfid=VTR.US&back=EWRE
DLR	Digital Realty Trust Inc	/etf/ea/ETZCW.djhtm?c=1&etfid=DLR.US&back=EWRE
IRM	Iron Mountain Inc	/etf/ea/ETZCW.djhtm?c=1&etfid=IRM.US&back=EWRE
PLD	Prologis Inc	/etf/ea/ETZCW.djhtm?c=1&etfid=PLD.US&back=EWRE
