FDIS
AMZN	AMAZON.COM INC COMMON STOCK USD.01	/etf/ea/ETZCW.djhtm?c=1&etfid=AMZN.US&back=FDIS
TSLA	TESLA INC COMMON STOCK USD.001	/etf/ea/ETZCW.djhtm?c=1&etfid=TSLA.US&back=FDIS
HD	HOME DEPOT INC COMMON STOCK USD.05	/etf/ea/ETZCW.djhtm?c=1&etfid=HD.US&back=FDIS
MCD	MCDONALD S CORP COMMON STOCK USD.01	/etf/ea/ETZCW.djhtm?c=1&etfid=MCD.US&back=FDIS
NKE	NIKE INC  CL B COMMON STOCK	/etf/ea/ETZCW.djhtm?c=1&etfid=NKE.US&back=FDIS
LOW	LOWE S COS INC COMMON STOCK USD.5	/etf/ea/ETZCW.djhtm?c=1&etfid=LOW.US&back=FDIS
SBUX	STARBUCKS CORP COMMON STOCK USD.001	/etf/ea/ETZCW.djhtm?c=1&etfid=SBUX.US&back=FDIS
TGT	TARGET CORP COMMON STOCK USD.0833	/etf/ea/ETZCW.djhtm?c=1&etfid=TGT.US&back=FDIS
BKNG	BOOKING HOLDINGS INC COMMON STOCK USD.008	/etf/ea/ETZCW.djhtm?c=1&etfid=BKNG.US&back=FDIS
TJX	TJX COMPANIES INC COMMON STOCK USD1.0	/etf/ea/ETZCW.djhtm?c=1&etfid=TJX.US&back=FDIS
F	FORD MOTOR CO COMMON STOCK USD.01	/etf/ea/ETZCW.djhtm?c=1&etfid=F.US&back=FDIS
DG	DOLLAR GENERAL CORP COMMON STOCK USD.875	/etf/ea/ETZCW.djhtm?c=1&etfid=DG.US&back=FDIS
GM	GENERAL MOTORS CO COMMON STOCK USD.01	/etf/ea/ETZCW.djhtm?c=1&etfid=GM.US&back=FDIS
ORLY	O REILLY AUTOMOTIVE INC COMMON STOCK USD.01	/etf/ea/ETZCW.djhtm?c=1&etfid=ORLY.US&back=FDIS
CMG	CHIPOTLE MEXICAN GRILL INC COMMON STOCK USD.01	/etf/ea/ETZCW.djhtm?c=1&etfid=CMG.US&back=FDIS
AZO	AUTOZONE INC COMMON STOCK USD.01	/etf/ea/ETZCW.djhtm?c=1&etfid=AZO.US&back=FDIS
MAR	MARRIOTT INTERNATIONAL  CL A COMMON STOCK USD.01	/etf/ea/ETZCW.djhtm?c=1&etfid=MAR.US&back=FDIS
ABNB	AIRBNB INC CLASS A COMMON STOCK USD.0001	/etf/ea/ETZCW.djhtm?c=1&etfid=ABNB.US&back=FDIS
MELI	MERCADOLIBRE INC COMMON STOCK USD.001	/etf/ea/ETZCW.djhtm?c=1&etfid=MELI.US&back=FDIS
HLT	HILTON WORLDWIDE HOLDINGS IN COMMON STOCK USD.01	/etf/ea/ETZCW.djhtm?c=1&etfid=HLT.US&back=FDIS
LULU	LULULEMON ATHLETICA INC COMMON STOCK USD.005	/etf/ea/ETZCW.djhtm?c=1&etfid=LULU.US&back=FDIS
YUM	YUM  BRANDS INC COMMON STOCK	/etf/ea/ETZCW.djhtm?c=1&etfid=YUM.US&back=FDIS
ROST	ROSS STORES INC COMMON STOCK USD.01	/etf/ea/ETZCW.djhtm?c=1&etfid=ROST.US&back=FDIS
DLTR	DOLLAR TREE INC COMMON STOCK USD.01	/etf/ea/ETZCW.djhtm?c=1&etfid=DLTR.US&back=FDIS
EBAY	EBAY INC COMMON STOCK USD.001	/etf/ea/ETZCW.djhtm?c=1&etfid=EBAY.US&back=FDIS
APTV	APTIV PLC COMMON STOCK USD.01	/etf/ea/ETZCW.djhtm?c=1&etfid=APTV.US&back=FDIS
DHI	DR HORTON INC COMMON STOCK USD.01	/etf/ea/ETZCW.djhtm?c=1&etfid=DHI.US&back=FDIS
ULTA	ULTA BEAUTY INC COMMON STOCK USD.01	/etf/ea/ETZCW.djhtm?c=1&etfid=ULTA.US&back=FDIS
GPC	GENUINE PARTS CO COMMON STOCK USD1.0	/etf/ea/ETZCW.djhtm?c=1&etfid=GPC.US&back=FDIS
TSCO	TRACTOR SUPPLY COMPANY COMMON STOCK USD.008	/etf/ea/ETZCW.djhtm?c=1&etfid=TSCO.US&back=FDIS
LEN	LENNAR CORP A COMMON STOCK USD.1	/etf/ea/ETZCW.djhtm?c=1&etfid=LEN.US&back=FDIS
DRI	DARDEN RESTAURANTS INC COMMON STOCK	/etf/ea/ETZCW.djhtm?c=1&etfid=DRI.US&back=FDIS
BBY	BEST BUY CO INC COMMON STOCK USD.1	/etf/ea/ETZCW.djhtm?c=1&etfid=BBY.US&back=FDIS
EXPE	EXPEDIA GROUP INC COMMON STOCK USD.001	/etf/ea/ETZCW.djhtm?c=1&etfid=EXPE.US&back=FDIS
LKQ	LKQ CORP COMMON STOCK USD.01	/etf/ea/ETZCW.djhtm?c=1&etfid=LKQ.US&back=FDIS
KMX	CARMAX INC COMMON STOCK USD.5	/etf/ea/ETZCW.djhtm?c=1&etfid=KMX.US&back=FDIS
VFC	VF CORP COMMON STOCK	/etf/ea/ETZCW.djhtm?c=1&etfid=VFC.US&back=FDIS
DPZ	DOMINO S PIZZA INC COMMON STOCK USD.01	/etf/ea/ETZCW.djhtm?c=1&etfid=DPZ.US&back=FDIS
POOL	POOL CORP COMMON STOCK USD.001	/etf/ea/ETZCW.djhtm?c=1&etfid=POOL.US&back=FDIS
GRMN	GARMIN LTD COMMON STOCK CHF.1	/etf/ea/ETZCW.djhtm?c=1&etfid=GRMN.US&back=FDIS
ETSY	ETSY INC COMMON STOCK USD.001	/etf/ea/ETZCW.djhtm?c=1&etfid=ETSY.US&back=FDIS
NVR	NVR INC COMMON STOCK USD.01	/etf/ea/ETZCW.djhtm?c=1&etfid=NVR.US&back=FDIS
LVS	LAS VEGAS SANDS CORP COMMON STOCK USD.001	/etf/ea/ETZCW.djhtm?c=1&etfid=LVS.US&back=FDIS
MGM	MGM RESORTS INTERNATIONAL COMMON STOCK USD.01	/etf/ea/ETZCW.djhtm?c=1&etfid=MGM.US&back=FDIS
WSM	WILLIAMS SONOMA INC COMMON STOCK USD.01	/etf/ea/ETZCW.djhtm?c=1&etfid=WSM.US&back=FDIS
DASH	DOORDASH INC   A COMMON STOCK USD.00001	/etf/ea/ETZCW.djhtm?c=1&etfid=DASH.US&back=FDIS
HAS	HASBRO INC COMMON STOCK USD.5	/etf/ea/ETZCW.djhtm?c=1&etfid=HAS.US&back=FDIS
	SS INST TREAS PLUS MM FUND TRU SS INST TREAS PLUS MM FUND TR	
AAP	ADVANCE AUTO PARTS INC COMMON STOCK USD.0001	/etf/ea/ETZCW.djhtm?c=1&etfid=AAP.US&back=FDIS
PHM	PULTEGROUP INC COMMON STOCK USD.01	/etf/ea/ETZCW.djhtm?c=1&etfid=PHM.US&back=FDIS
SCI	SERVICE CORP INTERNATIONAL COMMON STOCK USD1.0	/etf/ea/ETZCW.djhtm?c=1&etfid=SCI.US&back=FDIS
RIVN	RIVIAN AUTOMOTIVE INC A COMMON STOCK USD.001	/etf/ea/ETZCW.djhtm?c=1&etfid=RIVN.US&back=FDIS
	BATH + BODY WORKS INC COMMON STOCK USD.5	
BURL	BURLINGTON STORES INC COMMON STOCK USD.0001	/etf/ea/ETZCW.djhtm?c=1&etfid=BURL.US&back=FDIS
RCL	ROYAL CARIBBEAN CRUISES LTD COMMON STOCK USD.01	/etf/ea/ETZCW.djhtm?c=1&etfid=RCL.US&back=FDIS
TPR	TAPESTRY INC COMMON STOCK USD.01	/etf/ea/ETZCW.djhtm?c=1&etfid=TPR.US&back=FDIS
WHR	WHIRLPOOL CORP COMMON STOCK USD1.0	/etf/ea/ETZCW.djhtm?c=1&etfid=WHR.US&back=FDIS
MTN	VAIL RESORTS INC COMMON STOCK USD.01	/etf/ea/ETZCW.djhtm?c=1&etfid=MTN.US&back=FDIS
BWA	BORGWARNER INC COMMON STOCK USD.01	/etf/ea/ETZCW.djhtm?c=1&etfid=BWA.US&back=FDIS
DECK	DECKERS OUTDOOR CORP COMMON STOCK USD.01	/etf/ea/ETZCW.djhtm?c=1&etfid=DECK.US&back=FDIS
CCL	CARNIVAL CORP COMMON STOCK USD.01	/etf/ea/ETZCW.djhtm?c=1&etfid=CCL.US&back=FDIS
CZR	CAESARS ENTERTAINMENT INC COMMON STOCK	/etf/ea/ETZCW.djhtm?c=1&etfid=CZR.US&back=FDIS
ARMK	ARAMARK COMMON STOCK USD.01	/etf/ea/ETZCW.djhtm?c=1&etfid=ARMK.US&back=FDIS
LEA	LEAR CORP COMMON STOCK USD.01	/etf/ea/ETZCW.djhtm?c=1&etfid=LEA.US&back=FDIS
FND	FLOOR + DECOR HOLDINGS INC A COMMON STOCK USD.001	/etf/ea/ETZCW.djhtm?c=1&etfid=FND.US&back=FDIS
LAD	LITHIA MOTORS INC COMMON STOCK	/etf/ea/ETZCW.djhtm?c=1&etfid=LAD.US&back=FDIS
MAT	MATTEL INC COMMON STOCK USD1.0	/etf/ea/ETZCW.djhtm?c=1&etfid=MAT.US&back=FDIS
HRB	H+R BLOCK INC COMMON STOCK	/etf/ea/ETZCW.djhtm?c=1&etfid=HRB.US&back=FDIS
GME	GAMESTOP CORP CLASS A COMMON STOCK USD.001	/etf/ea/ETZCW.djhtm?c=1&etfid=GME.US&back=FDIS
FIVE	FIVE BELOW COMMON STOCK USD.01	/etf/ea/ETZCW.djhtm?c=1&etfid=FIVE.US&back=FDIS
NWL	NEWELL BRANDS INC COMMON STOCK USD1.0	/etf/ea/ETZCW.djhtm?c=1&etfid=NWL.US&back=FDIS
MUSA	MURPHY USA INC COMMON STOCK	/etf/ea/ETZCW.djhtm?c=1&etfid=MUSA.US&back=FDIS
CPRI	CAPRI HOLDINGS LTD COMMON STOCK	/etf/ea/ETZCW.djhtm?c=1&etfid=CPRI.US&back=FDIS
DKS	DICK S SPORTING GOODS INC COMMON STOCK USD.01	/etf/ea/ETZCW.djhtm?c=1&etfid=DKS.US&back=FDIS
CHDN	CHURCHILL DOWNS INC COMMON STOCK	/etf/ea/ETZCW.djhtm?c=1&etfid=CHDN.US&back=FDIS
WYNN	WYNN RESORTS LTD COMMON STOCK USD.01	/etf/ea/ETZCW.djhtm?c=1&etfid=WYNN.US&back=FDIS
PII	POLARIS INC COMMON STOCK USD.01	/etf/ea/ETZCW.djhtm?c=1&etfid=PII.US&back=FDIS
ALV	AUTOLIV INC COMMON STOCK USD1.0	/etf/ea/ETZCW.djhtm?c=1&etfid=ALV.US&back=FDIS
GNTX	GENTEX CORP COMMON STOCK USD.06	/etf/ea/ETZCW.djhtm?c=1&etfid=GNTX.US&back=FDIS
BLD	TOPBUILD CORP COMMON STOCK	/etf/ea/ETZCW.djhtm?c=1&etfid=BLD.US&back=FDIS
TXRH	TEXAS ROADHOUSE INC COMMON STOCK USD.001	/etf/ea/ETZCW.djhtm?c=1&etfid=TXRH.US&back=FDIS
WH	WYNDHAM HOTELS + RESORTS INC COMMON STOCK USD.01	/etf/ea/ETZCW.djhtm?c=1&etfid=WH.US&back=FDIS
LCID	LUCID GROUP INC COMMON STOCK USD.0001	/etf/ea/ETZCW.djhtm?c=1&etfid=LCID.US&back=FDIS
BC	BRUNSWICK CORP COMMON STOCK USD.75	/etf/ea/ETZCW.djhtm?c=1&etfid=BC.US&back=FDIS
VAC	MARRIOTT VACATIONS WORLD COMMON STOCK USD.01	/etf/ea/ETZCW.djhtm?c=1&etfid=VAC.US&back=FDIS
HOG	HARLEY DAVIDSON INC COMMON STOCK USD.01	/etf/ea/ETZCW.djhtm?c=1&etfid=HOG.US&back=FDIS
PLNT	PLANET FITNESS INC   CL A COMMON STOCK USD.0001	/etf/ea/ETZCW.djhtm?c=1&etfid=PLNT.US&back=FDIS
MHK	MOHAWK INDUSTRIES INC COMMON STOCK USD.01	/etf/ea/ETZCW.djhtm?c=1&etfid=MHK.US&back=FDIS
DKNG	DRAFTKINGS INC CL A COMMON STOCK USD.0001	/etf/ea/ETZCW.djhtm?c=1&etfid=DKNG.US&back=FDIS
NCLH	NORWEGIAN CRUISE LINE HOLDIN COMMON STOCK USD.001	/etf/ea/ETZCW.djhtm?c=1&etfid=NCLH.US&back=FDIS
PENN	PENN ENTERTAINMENT INC COMMON STOCK USD.01	/etf/ea/ETZCW.djhtm?c=1&etfid=PENN.US&back=FDIS
TMX	TERMINIX GLOBAL HOLDINGS INC COMMON STOCK USD.01	/etf/ea/ETZCW.djhtm?c=1&etfid=TMX.US&back=FDIS
SKX	SKECHERS USA INC CL A COMMON STOCK USD.001	/etf/ea/ETZCW.djhtm?c=1&etfid=SKX.US&back=FDIS
LEG	LEGGETT + PLATT INC COMMON STOCK USD.01	/etf/ea/ETZCW.djhtm?c=1&etfid=LEG.US&back=FDIS
AN	AUTONATION INC COMMON STOCK USD.01	/etf/ea/ETZCW.djhtm?c=1&etfid=AN.US&back=FDIS
M	MACY S INC COMMON STOCK USD.01	/etf/ea/ETZCW.djhtm?c=1&etfid=M.US&back=FDIS
TOL	TOLL BROTHERS INC COMMON STOCK USD.01	/etf/ea/ETZCW.djhtm?c=1&etfid=TOL.US&back=FDIS
CROX	CROCS INC COMMON STOCK USD.001	/etf/ea/ETZCW.djhtm?c=1&etfid=CROX.US&back=FDIS
THO	THOR INDUSTRIES INC COMMON STOCK USD.1	/etf/ea/ETZCW.djhtm?c=1&etfid=THO.US&back=FDIS
BYD	BOYD GAMING CORP COMMON STOCK USD.01	/etf/ea/ETZCW.djhtm?c=1&etfid=BYD.US&back=FDIS
RH	RH COMMON STOCK USD.0001	/etf/ea/ETZCW.djhtm?c=1&etfid=RH.US&back=FDIS
TPX	TEMPUR SEALY INTERNATIONAL I COMMON STOCK USD.01	/etf/ea/ETZCW.djhtm?c=1&etfid=TPX.US&back=FDIS
RL	RALPH LAUREN CORP COMMON STOCK USD.01	/etf/ea/ETZCW.djhtm?c=1&etfid=RL.US&back=FDIS
CHH	CHOICE HOTELS INTL INC COMMON STOCK USD.01	/etf/ea/ETZCW.djhtm?c=1&etfid=CHH.US&back=FDIS
GT	GOODYEAR TIRE + RUBBER CO COMMON STOCK	/etf/ea/ETZCW.djhtm?c=1&etfid=GT.US&back=FDIS
FOXF	FOX FACTORY HOLDING CORP COMMON STOCK USD.001	/etf/ea/ETZCW.djhtm?c=1&etfid=FOXF.US&back=FDIS
H	HYATT HOTELS CORP   CL A COMMON STOCK USD.01	/etf/ea/ETZCW.djhtm?c=1&etfid=H.US&back=FDIS
BFAM	BRIGHT HORIZONS FAMILY SOLUT COMMON STOCK USD.001	/etf/ea/ETZCW.djhtm?c=1&etfid=BFAM.US&back=FDIS
ABG	ASBURY AUTOMOTIVE GROUP COMMON STOCK USD.01	/etf/ea/ETZCW.djhtm?c=1&etfid=ABG.US&back=FDIS
LNW	LIGHT + WONDER INC COMMON STOCK USD.01	/etf/ea/ETZCW.djhtm?c=1&etfid=LNW.US&back=FDIS
PVH	PVH CORP COMMON STOCK USD1.0	/etf/ea/ETZCW.djhtm?c=1&etfid=PVH.US&back=FDIS
KSS	KOHLS CORP COMMON STOCK USD.01	/etf/ea/ETZCW.djhtm?c=1&etfid=KSS.US&back=FDIS
WING	WINGSTOP INC COMMON STOCK USD.01	/etf/ea/ETZCW.djhtm?c=1&etfid=WING.US&back=FDIS
PAG	PENSKE AUTOMOTIVE GROUP INC COMMON STOCK USD.0001	/etf/ea/ETZCW.djhtm?c=1&etfid=PAG.US&back=FDIS
WEN	WENDY S CO/THE COMMON STOCK USD.1	/etf/ea/ETZCW.djhtm?c=1&etfid=WEN.US&back=FDIS
HGV	HILTON GRAND VACATIONS INC COMMON STOCK USD.01	/etf/ea/ETZCW.djhtm?c=1&etfid=HGV.US&back=FDIS
TNL	TRAVEL   LEISURE CO COMMON STOCK USD.01	/etf/ea/ETZCW.djhtm?c=1&etfid=TNL.US&back=FDIS
SIG	SIGNET JEWELERS LTD COMMON STOCK USD.18	/etf/ea/ETZCW.djhtm?c=1&etfid=SIG.US&back=FDIS
VC	VISTEON CORP COMMON STOCK	/etf/ea/ETZCW.djhtm?c=1&etfid=VC.US&back=FDIS
FL	FOOT LOCKER INC COMMON STOCK USD.01	/etf/ea/ETZCW.djhtm?c=1&etfid=FL.US&back=FDIS
W	WAYFAIR INC  CLASS A COMMON STOCK USD.001	/etf/ea/ETZCW.djhtm?c=1&etfid=W.US&back=FDIS
OLLI	OLLIE S BARGAIN OUTLET HOLDI COMMON STOCK USD.001	/etf/ea/ETZCW.djhtm?c=1&etfid=OLLI.US&back=FDIS
ADNT	ADIENT PLC COMMON STOCK USD.001	/etf/ea/ETZCW.djhtm?c=1&etfid=ADNT.US&back=FDIS
SKY	SKYLINE CHAMPION CORP COMMON STOCK USD.028	/etf/ea/ETZCW.djhtm?c=1&etfid=SKY.US&back=FDIS
CRI	CARTER S INC COMMON STOCK USD.01	/etf/ea/ETZCW.djhtm?c=1&etfid=CRI.US&back=FDIS
YETI	YETI HOLDINGS INC COMMON STOCK USD.01	/etf/ea/ETZCW.djhtm?c=1&etfid=YETI.US&back=FDIS
HBI	HANESBRANDS INC COMMON STOCK USD.01	/etf/ea/ETZCW.djhtm?c=1&etfid=HBI.US&back=FDIS
LCII	LCI INDUSTRIES COMMON STOCK USD.01	/etf/ea/ETZCW.djhtm?c=1&etfid=LCII.US&back=FDIS
GPI	GROUP 1 AUTOMOTIVE INC COMMON STOCK USD.01	/etf/ea/ETZCW.djhtm?c=1&etfid=GPI.US&back=FDIS
EYE	NATIONAL VISION HOLDINGS INC COMMON STOCK USD.01	/etf/ea/ETZCW.djhtm?c=1&etfid=EYE.US&back=FDIS
ASO	ACADEMY SPORTS + OUTDOORS IN COMMON STOCK USD.01	/etf/ea/ETZCW.djhtm?c=1&etfid=ASO.US&back=FDIS
MTH	MERITAGE HOMES CORP COMMON STOCK USD.01	/etf/ea/ETZCW.djhtm?c=1&etfid=MTH.US&back=FDIS
LOPE	GRAND CANYON EDUCATION INC COMMON STOCK USD.01	/etf/ea/ETZCW.djhtm?c=1&etfid=LOPE.US&back=FDIS
TMHC	TAYLOR MORRISON HOME CORP COMMON STOCK USD.00001	/etf/ea/ETZCW.djhtm?c=1&etfid=TMHC.US&back=FDIS
HELE	HELEN OF TROY LTD COMMON STOCK USD.1	/etf/ea/ETZCW.djhtm?c=1&etfid=HELE.US&back=FDIS
VSCO	VICTORIA S SECRET + CO COMMON STOCK USD.01	/etf/ea/ETZCW.djhtm?c=1&etfid=VSCO.US&back=FDIS
PZZA	PAPA JOHN S INTL INC COMMON STOCK USD.01	/etf/ea/ETZCW.djhtm?c=1&etfid=PZZA.US&back=FDIS
	CALLAWAY GOLF COMPANY COMMON STOCK USD.01	
IBP	INSTALLED BUILDING PRODUCTS COMMON STOCK USD.01	/etf/ea/ETZCW.djhtm?c=1&etfid=IBP.US&back=FDIS
CHWY	CHEWY INC   CLASS A COMMON STOCK USD.01	/etf/ea/ETZCW.djhtm?c=1&etfid=CHWY.US&back=FDIS
COLM	COLUMBIA SPORTSWEAR CO COMMON STOCK	/etf/ea/ETZCW.djhtm?c=1&etfid=COLM.US&back=FDIS
SEAS	SEAWORLD ENTERTAINMENT INC COMMON STOCK USD.01	/etf/ea/ETZCW.djhtm?c=1&etfid=SEAS.US&back=FDIS
CBRL	CRACKER BARREL OLD COUNTRY COMMON STOCK USD.01	/etf/ea/ETZCW.djhtm?c=1&etfid=CBRL.US&back=FDIS
DORM	DORMAN PRODUCTS INC COMMON STOCK USD.01	/etf/ea/ETZCW.djhtm?c=1&etfid=DORM.US&back=FDIS
PTON	PELOTON INTERACTIVE INC A COMMON STOCK USD.000025	/etf/ea/ETZCW.djhtm?c=1&etfid=PTON.US&back=FDIS
CVNA	CARVANA CO COMMON STOCK USD.001	/etf/ea/ETZCW.djhtm?c=1&etfid=CVNA.US&back=FDIS
CHGG	CHEGG INC COMMON STOCK USD.001	/etf/ea/ETZCW.djhtm?c=1&etfid=CHGG.US&back=FDIS
GHC	GRAHAM HOLDINGS CO CLASS B COMMON STOCK USD1.0	/etf/ea/ETZCW.djhtm?c=1&etfid=GHC.US&back=FDIS
KBH	KB HOME COMMON STOCK USD1.0	/etf/ea/ETZCW.djhtm?c=1&etfid=KBH.US&back=FDIS
SHOO	STEVEN MADDEN LTD COMMON STOCK USD.0001	/etf/ea/ETZCW.djhtm?c=1&etfid=SHOO.US&back=FDIS
RRR	RED ROCK RESORTS INC CLASS A COMMON STOCK USD.01	/etf/ea/ETZCW.djhtm?c=1&etfid=RRR.US&back=FDIS
CVCO	CAVCO INDUSTRIES INC COMMON STOCK USD.01	/etf/ea/ETZCW.djhtm?c=1&etfid=CVCO.US&back=FDIS
LGIH	LGI HOMES INC COMMON STOCK USD.01	/etf/ea/ETZCW.djhtm?c=1&etfid=LGIH.US&back=FDIS
ATGE	ADTALEM GLOBAL EDUCATION INC COMMON STOCK USD.01	/etf/ea/ETZCW.djhtm?c=1&etfid=ATGE.US&back=FDIS
DAN	DANA INC COMMON STOCK USD.01	/etf/ea/ETZCW.djhtm?c=1&etfid=DAN.US&back=FDIS
WGO	WINNEBAGO INDUSTRIES COMMON STOCK USD.5	/etf/ea/ETZCW.djhtm?c=1&etfid=WGO.US&back=FDIS
THRM	GENTHERM INC COMMON STOCK	/etf/ea/ETZCW.djhtm?c=1&etfid=THRM.US&back=FDIS
KTB	KONTOOR BRANDS INC COMMON STOCK	/etf/ea/ETZCW.djhtm?c=1&etfid=KTB.US&back=FDIS
BOOT	BOOT BARN HOLDINGS INC COMMON STOCK USD.0001	/etf/ea/ETZCW.djhtm?c=1&etfid=BOOT.US&back=FDIS
FTDR	FRONTDOOR INC COMMON STOCK USD.01	/etf/ea/ETZCW.djhtm?c=1&etfid=FTDR.US&back=FDIS
GOLF	ACUSHNET HOLDINGS CORP COMMON STOCK USD.001	/etf/ea/ETZCW.djhtm?c=1&etfid=GOLF.US&back=FDIS
DDS	DILLARDS INC CL A COMMON STOCK	/etf/ea/ETZCW.djhtm?c=1&etfid=DDS.US&back=FDIS
OXM	OXFORD INDUSTRIES INC COMMON STOCK USD1.0	/etf/ea/ETZCW.djhtm?c=1&etfid=OXM.US&back=FDIS
JACK	JACK IN THE BOX INC COMMON STOCK USD.01	/etf/ea/ETZCW.djhtm?c=1&etfid=JACK.US&back=FDIS
GPS	GAP INC/THE COMMON STOCK USD.05	/etf/ea/ETZCW.djhtm?c=1&etfid=GPS.US&back=FDIS
IRBT	IROBOT CORP COMMON STOCK USD.01	/etf/ea/ETZCW.djhtm?c=1&etfid=IRBT.US&back=FDIS
TPH	TRI POINTE HOMES INC COMMON STOCK USD.01	/etf/ea/ETZCW.djhtm?c=1&etfid=TPH.US&back=FDIS
JWN	NORDSTROM INC COMMON STOCK	/etf/ea/ETZCW.djhtm?c=1&etfid=JWN.US&back=FDIS
EVRI	EVERI HOLDINGS INC COMMON STOCK USD.001	/etf/ea/ETZCW.djhtm?c=1&etfid=EVRI.US&back=FDIS
BLMN	BLOOMIN  BRANDS INC COMMON STOCK USD.01	/etf/ea/ETZCW.djhtm?c=1&etfid=BLMN.US&back=FDIS
AEO	AMERICAN EAGLE OUTFITTERS COMMON STOCK USD.01	/etf/ea/ETZCW.djhtm?c=1&etfid=AEO.US&back=FDIS
SHAK	SHAKE SHACK INC   CLASS A COMMON STOCK USD.01	/etf/ea/ETZCW.djhtm?c=1&etfid=SHAK.US&back=FDIS
	MDC HOLDINGS INC COMMON STOCK USD.01	
PLAY	DAVE + BUSTER S ENTERTAINMEN COMMON STOCK USD.01	/etf/ea/ETZCW.djhtm?c=1&etfid=PLAY.US&back=FDIS
TEN	TENNECO INC CLASS A COMMON STOCK USD.01	/etf/ea/ETZCW.djhtm?c=1&etfid=TEN.US&back=FDIS
SBH	SALLY BEAUTY HOLDINGS INC COMMON STOCK USD.01	/etf/ea/ETZCW.djhtm?c=1&etfid=SBH.US&back=FDIS
WWW	WOLVERINE WORLD WIDE INC COMMON STOCK USD1.0	/etf/ea/ETZCW.djhtm?c=1&etfid=WWW.US&back=FDIS
SIX	SIX FLAGS ENTERTAINMENT CORP COMMON STOCK	/etf/ea/ETZCW.djhtm?c=1&etfid=SIX.US&back=FDIS
MNRO	MONRO INC COMMON STOCK USD.01	/etf/ea/ETZCW.djhtm?c=1&etfid=MNRO.US&back=FDIS
LRN	STRIDE INC COMMON STOCK USD.0001	/etf/ea/ETZCW.djhtm?c=1&etfid=LRN.US&back=FDIS
UA	UNDER ARMOUR INC CLASS C COMMON STOCK USD.000333	/etf/ea/ETZCW.djhtm?c=1&etfid=UA.US&back=FDIS
LESL	LESLIE S INC COMMON STOCK USD.001	/etf/ea/ETZCW.djhtm?c=1&etfid=LESL.US&back=FDIS
ODP	ODP CORP/THE COMMON STOCK USD.01	/etf/ea/ETZCW.djhtm?c=1&etfid=ODP.US&back=FDIS
UAA	UNDER ARMOUR INC CLASS A COMMON STOCK USD.000333	/etf/ea/ETZCW.djhtm?c=1&etfid=UAA.US&back=FDIS
STRA	STRATEGIC EDUCATION INC COMMON STOCK USD.01	/etf/ea/ETZCW.djhtm?c=1&etfid=STRA.US&back=FDIS
VSTO	VISTA OUTDOOR INC COMMON STOCK USD.01	/etf/ea/ETZCW.djhtm?c=1&etfid=VSTO.US&back=FDIS
RCII	RENT A CENTER INC COMMON STOCK USD.01	/etf/ea/ETZCW.djhtm?c=1&etfid=RCII.US&back=FDIS
CAKE	CHEESECAKE FACTORY INC/THE COMMON STOCK USD.01	/etf/ea/ETZCW.djhtm?c=1&etfid=CAKE.US&back=FDIS
LEVI	LEVI STRAUSS + CO  CLASS A COMMON STOCK USD.001	/etf/ea/ETZCW.djhtm?c=1&etfid=LEVI.US&back=FDIS
AXL	AMERICAN AXLE + MFG HOLDINGS COMMON STOCK USD.01	/etf/ea/ETZCW.djhtm?c=1&etfid=AXL.US&back=FDIS
SONO	SONOS INC COMMON STOCK USD.001	/etf/ea/ETZCW.djhtm?c=1&etfid=SONO.US&back=FDIS
CCS	CENTURY COMMUNITIES INC COMMON STOCK USD.01	/etf/ea/ETZCW.djhtm?c=1&etfid=CCS.US&back=FDIS
CWH	CAMPING WORLD HOLDINGS INC A COMMON STOCK USD.01	/etf/ea/ETZCW.djhtm?c=1&etfid=CWH.US&back=FDIS
MBUU	MALIBU BOATS INC   A COMMON STOCK USD.01	/etf/ea/ETZCW.djhtm?c=1&etfid=MBUU.US&back=FDIS
URBN	URBAN OUTFITTERS INC COMMON STOCK USD.0001	/etf/ea/ETZCW.djhtm?c=1&etfid=URBN.US&back=FDIS
	US DOLLAR	
SAH	SONIC AUTOMOTIVE INC CLASS A COMMON STOCK USD.01	/etf/ea/ETZCW.djhtm?c=1&etfid=SAH.US&back=FDIS
MHO	M/I HOMES INC COMMON STOCK USD.01	/etf/ea/ETZCW.djhtm?c=1&etfid=MHO.US&back=FDIS
LAUR	LAUREATE EDUCATION INC COMMON STOCK USD.001	/etf/ea/ETZCW.djhtm?c=1&etfid=LAUR.US&back=FDIS
LZB	LA Z BOY INC COMMON STOCK USD1.0	/etf/ea/ETZCW.djhtm?c=1&etfid=LZB.US&back=FDIS
DBI	DESIGNER BRANDS INC CLASS A COMMON STOCK	/etf/ea/ETZCW.djhtm?c=1&etfid=DBI.US&back=FDIS
LAZR	LUMINAR TECHNOLOGIES INC COMMON STOCK USD.0001	/etf/ea/ETZCW.djhtm?c=1&etfid=LAZR.US&back=FDIS
DIN	DINE BRANDS GLOBAL INC COMMON STOCK USD.01	/etf/ea/ETZCW.djhtm?c=1&etfid=DIN.US&back=FDIS
EAT	BRINKER INTERNATIONAL INC COMMON STOCK USD.1	/etf/ea/ETZCW.djhtm?c=1&etfid=EAT.US&back=FDIS
BBBY	BED BATH + BEYOND INC COMMON STOCK USD.01	/etf/ea/ETZCW.djhtm?c=1&etfid=BBBY.US&back=FDIS
BKE	BUCKLE INC/THE COMMON STOCK USD.01	/etf/ea/ETZCW.djhtm?c=1&etfid=BKE.US&back=FDIS
QRTEA	QURATE RETAIL INC COMMON STOCK USD.01	/etf/ea/ETZCW.djhtm?c=1&etfid=QRTEA.US&back=FDIS
DUOL	DUOLINGO COMMON STOCK USD.0001	/etf/ea/ETZCW.djhtm?c=1&etfid=DUOL.US&back=FDIS
SNBR	SLEEP NUMBER CORP COMMON STOCK USD.01	/etf/ea/ETZCW.djhtm?c=1&etfid=SNBR.US&back=FDIS
PRDO	PERDOCEO EDUCATION CORP COMMON STOCK USD.01	/etf/ea/ETZCW.djhtm?c=1&etfid=PRDO.US&back=FDIS
OSTK	OVERSTOCK.COM INC COMMON STOCK USD.0001	/etf/ea/ETZCW.djhtm?c=1&etfid=OSTK.US&back=FDIS
HIBB	HIBBETT INC COMMON STOCK USD.01	/etf/ea/ETZCW.djhtm?c=1&etfid=HIBB.US&back=FDIS
GIII	G III APPAREL GROUP LTD COMMON STOCK USD.01	/etf/ea/ETZCW.djhtm?c=1&etfid=GIII.US&back=FDIS
GRBK	GREEN BRICK PARTNERS INC COMMON STOCK USD.01	/etf/ea/ETZCW.djhtm?c=1&etfid=GRBK.US&back=FDIS
MCRI	MONARCH CASINO + RESORT INC COMMON STOCK USD.01	/etf/ea/ETZCW.djhtm?c=1&etfid=MCRI.US&back=FDIS
FSR	FISKER INC COMMON STOCK USD.00001	/etf/ea/ETZCW.djhtm?c=1&etfid=FSR.US&back=FDIS
RVLV	REVOLVE GROUP INC COMMON STOCK USD.001	/etf/ea/ETZCW.djhtm?c=1&etfid=RVLV.US&back=FDIS
RGR	STURM RUGER + CO INC COMMON STOCK USD1.0	/etf/ea/ETZCW.djhtm?c=1&etfid=RGR.US&back=FDIS
BALY	BALLY S CORP COMMON STOCK USD.01	/etf/ea/ETZCW.djhtm?c=1&etfid=BALY.US&back=FDIS
GCO	GENESCO INC COMMON STOCK USD1.0	/etf/ea/ETZCW.djhtm?c=1&etfid=GCO.US&back=FDIS
GPRO	GOPRO INC CLASS A COMMON STOCK USD.0001	/etf/ea/ETZCW.djhtm?c=1&etfid=GPRO.US&back=FDIS
HZO	MARINEMAX INC COMMON STOCK USD.001	/etf/ea/ETZCW.djhtm?c=1&etfid=HZO.US&back=FDIS
PLYA	PLAYA HOTELS + RESORTS NV COMMON STOCK USD.01	/etf/ea/ETZCW.djhtm?c=1&etfid=PLYA.US&back=FDIS
SMP	STANDARD MOTOR PRODS COMMON STOCK USD2.0	/etf/ea/ETZCW.djhtm?c=1&etfid=SMP.US&back=FDIS
WOOF	PETCO HEALTH AND WELLNESS CO COMMON STOCK USD.001	/etf/ea/ETZCW.djhtm?c=1&etfid=WOOF.US&back=FDIS
WINA	WINMARK CORP COMMON STOCK	/etf/ea/ETZCW.djhtm?c=1&etfid=WINA.US&back=FDIS
XPEL	XPEL INC COMMON STOCK	/etf/ea/ETZCW.djhtm?c=1&etfid=XPEL.US&back=FDIS
ANF	ABERCROMBIE + FITCH CO CL A COMMON STOCK USD.01	/etf/ea/ETZCW.djhtm?c=1&etfid=ANF.US&back=FDIS
GES	GUESS? INC COMMON STOCK USD.01	/etf/ea/ETZCW.djhtm?c=1&etfid=GES.US&back=FDIS
RUTH	RUTH S HOSPITALITY GROUP INC COMMON STOCK USD.01	/etf/ea/ETZCW.djhtm?c=1&etfid=RUTH.US&back=FDIS
SWBI	SMITH + WESSON BRANDS INC COMMON STOCK USD.001	/etf/ea/ETZCW.djhtm?c=1&etfid=SWBI.US&back=FDIS
BJRI	BJ S RESTAURANTS INC COMMON STOCK	/etf/ea/ETZCW.djhtm?c=1&etfid=BJRI.US&back=FDIS
ADT	ADT INC COMMON STOCK USD.01	/etf/ea/ETZCW.djhtm?c=1&etfid=ADT.US&back=FDIS
DENN	DENNY S CORP COMMON STOCK USD.01	/etf/ea/ETZCW.djhtm?c=1&etfid=DENN.US&back=FDIS
ETD	ETHAN ALLEN INTERIORS INC COMMON STOCK USD.01	/etf/ea/ETZCW.djhtm?c=1&etfid=ETD.US&back=FDIS
OSW	ONESPAWORLD HOLDINGS LTD COMMON STOCK USD.0001	/etf/ea/ETZCW.djhtm?c=1&etfid=OSW.US&back=FDIS
PLCE	CHILDREN S PLACE INC/THE COMMON STOCK USD.1	/etf/ea/ETZCW.djhtm?c=1&etfid=PLCE.US&back=FDIS
ACEL	ACCEL ENTERTAINMENT INC COMMON STOCK USD.0001	/etf/ea/ETZCW.djhtm?c=1&etfid=ACEL.US&back=FDIS
SRI	STONERIDGE INC COMMON STOCK	/etf/ea/ETZCW.djhtm?c=1&etfid=SRI.US&back=FDIS
PATK	PATRICK INDUSTRIES INC COMMON STOCK	/etf/ea/ETZCW.djhtm?c=1&etfid=PATK.US&back=FDIS
CSV	CARRIAGE SERVICES INC COMMON STOCK USD.01	/etf/ea/ETZCW.djhtm?c=1&etfid=CSV.US&back=FDIS
HVT	HAVERTY FURNITURE COMMON STOCK USD1.0	/etf/ea/ETZCW.djhtm?c=1&etfid=HVT.US&back=FDIS
BIG	BIG LOTS INC COMMON STOCK USD.01	/etf/ea/ETZCW.djhtm?c=1&etfid=BIG.US&back=FDIS
PETS	PETMED EXPRESS INC COMMON STOCK USD.001	/etf/ea/ETZCW.djhtm?c=1&etfid=PETS.US&back=FDIS
ZUMZ	ZUMIEZ INC COMMON STOCK	/etf/ea/ETZCW.djhtm?c=1&etfid=ZUMZ.US&back=FDIS
CRMT	AMERICA S CAR MART INC COMMON STOCK USD.01	/etf/ea/ETZCW.djhtm?c=1&etfid=CRMT.US&back=FDIS
SCVL	SHOE CARNIVAL INC COMMON STOCK USD.01	/etf/ea/ETZCW.djhtm?c=1&etfid=SCVL.US&back=FDIS
JOUT	JOHNSON OUTDOORS INC A COMMON STOCK USD.05	/etf/ea/ETZCW.djhtm?c=1&etfid=JOUT.US&back=FDIS
CAL	CALERES INC COMMON STOCK USD.01	/etf/ea/ETZCW.djhtm?c=1&etfid=CAL.US&back=FDIS
FRG	FRANCHISE GROUP INC COMMON STOCK USD.01	/etf/ea/ETZCW.djhtm?c=1&etfid=FRG.US&back=FDIS
BROS	DUTCH BROS INC CLASS A COMMON STOCK USD.00001	/etf/ea/ETZCW.djhtm?c=1&etfid=BROS.US&back=FDIS
UEIC	UNIVERSAL ELECTRONICS INC COMMON STOCK USD.01	/etf/ea/ETZCW.djhtm?c=1&etfid=UEIC.US&back=FDIS
PWSC	POWERSCHOOL HOLDINGS INC A COMMON STOCK USD.0001	/etf/ea/ETZCW.djhtm?c=1&etfid=PWSC.US&back=FDIS
WRBY	WARBY PARKER INC CLASS A COMMON STOCK USD.0001	/etf/ea/ETZCW.djhtm?c=1&etfid=WRBY.US&back=FDIS
LE	LANDS  END INC COMMON STOCK USD.01	/etf/ea/ETZCW.djhtm?c=1&etfid=LE.US&back=FDIS
DNUT	KRISPY KREME INC COMMON STOCK USD.01	/etf/ea/ETZCW.djhtm?c=1&etfid=DNUT.US&back=FDIS
LOCO	EL POLLO LOCO HOLDINGS INC COMMON STOCK USD.01	/etf/ea/ETZCW.djhtm?c=1&etfid=LOCO.US&back=FDIS
MCW	MISTER CAR WASH INC COMMON STOCK USD.01	/etf/ea/ETZCW.djhtm?c=1&etfid=MCW.US&back=FDIS
APEI	AMERICAN PUBLIC EDUCATION COMMON STOCK USD.01	/etf/ea/ETZCW.djhtm?c=1&etfid=APEI.US&back=FDIS
TA	TRAVELCENTERS OF AMERICA INC COMMON STOCK USD.00001	/etf/ea/ETZCW.djhtm?c=1&etfid=TA.US&back=FDIS
CHS	CHICO S FAS INC COMMON STOCK USD.01	/etf/ea/ETZCW.djhtm?c=1&etfid=CHS.US&back=FDIS
GDEN	GOLDEN ENTERTAINMENT INC COMMON STOCK USD.01	/etf/ea/ETZCW.djhtm?c=1&etfid=GDEN.US&back=FDIS
FLWS	1 800 FLOWERS.COM INC CL A COMMON STOCK USD.01	/etf/ea/ETZCW.djhtm?c=1&etfid=FLWS.US&back=FDIS
MOD	MODINE MANUFACTURING CO COMMON STOCK USD.625	/etf/ea/ETZCW.djhtm?c=1&etfid=MOD.US&back=FDIS
LIND	LINDBLAD EXPEDITIONS HOLDING COMMON STOCK USD.0001	/etf/ea/ETZCW.djhtm?c=1&etfid=LIND.US&back=FDIS
FNKO	FUNKO INC CLASS A COMMON STOCK USD.0001	/etf/ea/ETZCW.djhtm?c=1&etfid=FNKO.US&back=FDIS
SLDP	SOLID POWER INC COMMON STOCK USD.0001	/etf/ea/ETZCW.djhtm?c=1&etfid=SLDP.US&back=FDIS
COUR	COURSERA INC COMMON STOCK USD.00001	/etf/ea/ETZCW.djhtm?c=1&etfid=COUR.US&back=FDIS
GRPN	GROUPON INC COMMON STOCK USD.0001	/etf/ea/ETZCW.djhtm?c=1&etfid=GRPN.US&back=FDIS
AAN	AARON S CO INC/THE COMMON STOCK USD.5	/etf/ea/ETZCW.djhtm?c=1&etfid=AAN.US&back=FDIS
XMTR	XOMETRY INC A COMMON STOCK USD.000001	/etf/ea/ETZCW.djhtm?c=1&etfid=XMTR.US&back=FDIS
PTLO	PORTILLO S INC CL A COMMON STOCK USD.01	/etf/ea/ETZCW.djhtm?c=1&etfid=PTLO.US&back=FDIS
WISH	CONTEXTLOGIC INC   A COMMON STOCK USD.0001	/etf/ea/ETZCW.djhtm?c=1&etfid=WISH.US&back=FDIS
EVGO	EVGO INC COMMON STOCK USD.0001	/etf/ea/ETZCW.djhtm?c=1&etfid=EVGO.US&back=FDIS
WW	WW INTERNATIONAL INC COMMON STOCK	/etf/ea/ETZCW.djhtm?c=1&etfid=WW.US&back=FDIS
EWCZ	EUROPEAN WAX CENTER INC A COMMON STOCK USD.00001	/etf/ea/ETZCW.djhtm?c=1&etfid=EWCZ.US&back=FDIS
TWOU	2U INC COMMON STOCK USD.001	/etf/ea/ETZCW.djhtm?c=1&etfid=TWOU.US&back=FDIS
RICK	RCI HOSPITALITY HOLDINGS INC COMMON STOCK USD.01	/etf/ea/ETZCW.djhtm?c=1&etfid=RICK.US&back=FDIS
MOV	MOVADO GROUP INC COMMON STOCK USD.01	/etf/ea/ETZCW.djhtm?c=1&etfid=MOV.US&back=FDIS
WKHS	WORKHORSE GROUP INC COMMON STOCK USD.001	/etf/ea/ETZCW.djhtm?c=1&etfid=WKHS.US&back=FDIS
LQDT	LIQUIDITY SERVICES INC COMMON STOCK USD.001	/etf/ea/ETZCW.djhtm?c=1&etfid=LQDT.US&back=FDIS
TUP	TUPPERWARE BRANDS CORP COMMON STOCK USD.01	/etf/ea/ETZCW.djhtm?c=1&etfid=TUP.US&back=FDIS
SFIX	STITCH FIX INC CLASS A COMMON STOCK USD.00002	/etf/ea/ETZCW.djhtm?c=1&etfid=SFIX.US&back=FDIS
BOWL	BOWLERO CORP COMMON STOCK USD.0001	/etf/ea/ETZCW.djhtm?c=1&etfid=BOWL.US&back=FDIS
ARKO	ARKO CORP COMMON STOCK USD.0001	/etf/ea/ETZCW.djhtm?c=1&etfid=ARKO.US&back=FDIS
VUZI	VUZIX CORP COMMON STOCK	/etf/ea/ETZCW.djhtm?c=1&etfid=VUZI.US&back=FDIS
TH	TARGET HOSPITALITY CORP COMMON STOCK USD.0001	/etf/ea/ETZCW.djhtm?c=1&etfid=TH.US&back=FDIS
QUOT	QUOTIENT TECHNOLOGY INC COMMON STOCK USD.00001	/etf/ea/ETZCW.djhtm?c=1&etfid=QUOT.US&back=FDIS
LOVE	LOVESAC CO/THE COMMON STOCK USD.00001	/etf/ea/ETZCW.djhtm?c=1&etfid=LOVE.US&back=FDIS
CHUY	CHUY S HOLDINGS INC COMMON STOCK USD.01	/etf/ea/ETZCW.djhtm?c=1&etfid=CHUY.US&back=FDIS
BIRD	ALLBIRDS INC CL A COMMON STOCK USD.0001	/etf/ea/ETZCW.djhtm?c=1&etfid=BIRD.US&back=FDIS
SPWH	SPORTSMAN S WAREHOUSE HOLDIN COMMON STOCK USD.01	/etf/ea/ETZCW.djhtm?c=1&etfid=SPWH.US&back=FDIS
LTH	LIFE TIME GROUP HOLDINGS INC COMMON STOCK USD.01	/etf/ea/ETZCW.djhtm?c=1&etfid=LTH.US&back=FDIS
GOEV	CANOO INC COMMON STOCK USD.0001	/etf/ea/ETZCW.djhtm?c=1&etfid=GOEV.US&back=FDIS
POWW	AMMO INC COMMON STOCK	/etf/ea/ETZCW.djhtm?c=1&etfid=POWW.US&back=FDIS
RIDE	LORDSTOWN MOTORS CORP CL A COMMON STOCK USD.0001	/etf/ea/ETZCW.djhtm?c=1&etfid=RIDE.US&back=FDIS
PRTS	CARPARTS.COM INC COMMON STOCK USD.001	/etf/ea/ETZCW.djhtm?c=1&etfid=PRTS.US&back=FDIS
RSI	RUSH STREET INTERACTIVE INC COMMON STOCK USD.0001	/etf/ea/ETZCW.djhtm?c=1&etfid=RSI.US&back=FDIS
DLTH	DULUTH HOLDINGS INC   CL B COMMON STOCK	/etf/ea/ETZCW.djhtm?c=1&etfid=DLTH.US&back=FDIS
ROVR	ROVER GROUP INC COMMON STOCK USD.0001	/etf/ea/ETZCW.djhtm?c=1&etfid=ROVR.US&back=FDIS
SWIM	LATHAM GROUP INC COMMON STOCK USD.0001	/etf/ea/ETZCW.djhtm?c=1&etfid=SWIM.US&back=FDIS
GRWG	GROWGENERATION CORP COMMON STOCK USD.001	/etf/ea/ETZCW.djhtm?c=1&etfid=GRWG.US&back=FDIS
VVNT	VIVINT SMART HOME INC COMMON STOCK	/etf/ea/ETZCW.djhtm?c=1&etfid=VVNT.US&back=FDIS
PRTY	PARTY CITY HOLDCO INC COMMON STOCK USD.01	/etf/ea/ETZCW.djhtm?c=1&etfid=PRTY.US&back=FDIS
REAL	REALREAL INC/THE COMMON STOCK USD.00001	/etf/ea/ETZCW.djhtm?c=1&etfid=REAL.US&back=FDIS
VLTA	VOLTA INC COMMON STOCK USD.0001	/etf/ea/ETZCW.djhtm?c=1&etfid=VLTA.US&back=FDIS
HLLY	HOLLEY INC COMMON STOCK USD.0001	/etf/ea/ETZCW.djhtm?c=1&etfid=HLLY.US&back=FDIS
LL	LL FLOORING HOLDINGS INC COMMON STOCK USD.001	/etf/ea/ETZCW.djhtm?c=1&etfid=LL.US&back=FDIS
TCS	CONTAINER STORE GROUP INC/TH COMMON STOCK USD.01	/etf/ea/ETZCW.djhtm?c=1&etfid=TCS.US&back=FDIS
HOV	HOVNANIAN ENTERPRISES A COMMON STOCK USD.01	/etf/ea/ETZCW.djhtm?c=1&etfid=HOV.US&back=FDIS
DFH	DREAM FINDERS HOMES INC   A COMMON STOCK USD.01	/etf/ea/ETZCW.djhtm?c=1&etfid=DFH.US&back=FDIS
PRCH	PORCH GROUP INC COMMON STOCK USD.0001	/etf/ea/ETZCW.djhtm?c=1&etfid=PRCH.US&back=FDIS
SEAT	VIVID SEATS INC   CLASS A COMMON STOCK USD.0001	/etf/ea/ETZCW.djhtm?c=1&etfid=SEAT.US&back=FDIS
POSH	POSHMARK INC CLASS A COMMON STOCK USD.0001	/etf/ea/ETZCW.djhtm?c=1&etfid=POSH.US&back=FDIS
CLAR	CLARUS CORP COMMON STOCK USD.0001	/etf/ea/ETZCW.djhtm?c=1&etfid=CLAR.US&back=FDIS
CRCT	CRICUT INC   CLASS A COMMON STOCK USD.001	/etf/ea/ETZCW.djhtm?c=1&etfid=CRCT.US&back=FDIS
WEBR	WEBER INC   CLASS A COMMON STOCK USD.001	/etf/ea/ETZCW.djhtm?c=1&etfid=WEBR.US&back=FDIS
	XAY CONS DISCRET  SEP22 XCME 20220916	
SNPO	SNAP ONE HOLDINGS CORP COMMON STOCK USD.001	/etf/ea/ETZCW.djhtm?c=1&etfid=SNPO.US&back=FDIS
BARK	BARK INC COMMON STOCK USD.0001	/etf/ea/ETZCW.djhtm?c=1&etfid=BARK.US&back=FDIS
MCG	MEMBERSHIP COLLECTIVE GRP  A COMMON STOCK USD.01	/etf/ea/ETZCW.djhtm?c=1&etfid=MCG.US&back=FDIS
BODY	BEACHBODY CO INC/THE COMMON STOCK USD.0001	/etf/ea/ETZCW.djhtm?c=1&etfid=BODY.US&back=FDIS
COOK	TRAEGER INC COMMON STOCK	/etf/ea/ETZCW.djhtm?c=1&etfid=COOK.US&back=FDIS
TDUP	THREDUP INC   CLASS A COMMON STOCK USD.0001	/etf/ea/ETZCW.djhtm?c=1&etfid=TDUP.US&back=FDIS
PLBY	PLBY GROUP INC COMMON STOCK USD.0001	/etf/ea/ETZCW.djhtm?c=1&etfid=PLBY.US&back=FDIS
PRPL	PURPLE INNOVATION INC COMMON STOCK	/etf/ea/ETZCW.djhtm?c=1&etfid=PRPL.US&back=FDIS
