FHLC
UNH	UNITEDHEALTH GROUP INC COMMON STOCK USD.01	/etf/ea/ETZCW.djhtm?c=1&etfid=UNH.US&back=FHLC
JNJ	JOHNSON + JOHNSON COMMON STOCK USD1.0	/etf/ea/ETZCW.djhtm?c=1&etfid=JNJ.US&back=FHLC
PFE	PFIZER INC COMMON STOCK USD.05	/etf/ea/ETZCW.djhtm?c=1&etfid=PFE.US&back=FHLC
LLY	ELI LILLY + CO COMMON STOCK	/etf/ea/ETZCW.djhtm?c=1&etfid=LLY.US&back=FHLC
ABBV	ABBVIE INC COMMON STOCK USD.01	/etf/ea/ETZCW.djhtm?c=1&etfid=ABBV.US&back=FHLC
MRK	MERCK + CO. INC. COMMON STOCK USD.5	/etf/ea/ETZCW.djhtm?c=1&etfid=MRK.US&back=FHLC
TMO	THERMO FISHER SCIENTIFIC INC COMMON STOCK USD1.0	/etf/ea/ETZCW.djhtm?c=1&etfid=TMO.US&back=FHLC
DHR	DANAHER CORP COMMON STOCK USD.01	/etf/ea/ETZCW.djhtm?c=1&etfid=DHR.US&back=FHLC
ABT	ABBOTT LABORATORIES COMMON STOCK	/etf/ea/ETZCW.djhtm?c=1&etfid=ABT.US&back=FHLC
BMY	BRISTOL MYERS SQUIBB CO COMMON STOCK USD.1	/etf/ea/ETZCW.djhtm?c=1&etfid=BMY.US&back=FHLC
CVS	CVS HEALTH CORP COMMON STOCK USD.01	/etf/ea/ETZCW.djhtm?c=1&etfid=CVS.US&back=FHLC
AMGN	AMGEN INC COMMON STOCK USD.0001	/etf/ea/ETZCW.djhtm?c=1&etfid=AMGN.US&back=FHLC
MDT	MEDTRONIC PLC COMMON STOCK USD.1	/etf/ea/ETZCW.djhtm?c=1&etfid=MDT.US&back=FHLC
ELV	ELEVANCE HEALTH INC COMMON STOCK USD.01	/etf/ea/ETZCW.djhtm?c=1&etfid=ELV.US&back=FHLC
CI	CIGNA CORP COMMON STOCK USD.01	/etf/ea/ETZCW.djhtm?c=1&etfid=CI.US&back=FHLC
GILD	GILEAD SCIENCES INC COMMON STOCK USD.001	/etf/ea/ETZCW.djhtm?c=1&etfid=GILD.US&back=FHLC
ISRG	INTUITIVE SURGICAL INC COMMON STOCK USD.001	/etf/ea/ETZCW.djhtm?c=1&etfid=ISRG.US&back=FHLC
ZTS	ZOETIS INC COMMON STOCK USD.01	/etf/ea/ETZCW.djhtm?c=1&etfid=ZTS.US&back=FHLC
VRTX	VERTEX PHARMACEUTICALS INC COMMON STOCK USD.01	/etf/ea/ETZCW.djhtm?c=1&etfid=VRTX.US&back=FHLC
BDX	BECTON DICKINSON AND CO COMMON STOCK USD1.0	/etf/ea/ETZCW.djhtm?c=1&etfid=BDX.US&back=FHLC
SYK	STRYKER CORP COMMON STOCK USD.1	/etf/ea/ETZCW.djhtm?c=1&etfid=SYK.US&back=FHLC
REGN	REGENERON PHARMACEUTICALS COMMON STOCK USD.001	/etf/ea/ETZCW.djhtm?c=1&etfid=REGN.US&back=FHLC
HUM	HUMANA INC COMMON STOCK USD.1666666	/etf/ea/ETZCW.djhtm?c=1&etfid=HUM.US&back=FHLC
BSX	BOSTON SCIENTIFIC CORP COMMON STOCK USD.01	/etf/ea/ETZCW.djhtm?c=1&etfid=BSX.US&back=FHLC
EW	EDWARDS LIFESCIENCES CORP COMMON STOCK USD1.0	/etf/ea/ETZCW.djhtm?c=1&etfid=EW.US&back=FHLC
MCK	MCKESSON CORP COMMON STOCK USD.01	/etf/ea/ETZCW.djhtm?c=1&etfid=MCK.US&back=FHLC
CNC	CENTENE CORP COMMON STOCK USD.001	/etf/ea/ETZCW.djhtm?c=1&etfid=CNC.US&back=FHLC
HCA	HCA HEALTHCARE INC COMMON STOCK USD.01	/etf/ea/ETZCW.djhtm?c=1&etfid=HCA.US&back=FHLC
MRNA	MODERNA INC COMMON STOCK USD.0001	/etf/ea/ETZCW.djhtm?c=1&etfid=MRNA.US&back=FHLC
IQV	IQVIA HOLDINGS INC COMMON STOCK USD.01	/etf/ea/ETZCW.djhtm?c=1&etfid=IQV.US&back=FHLC
A	AGILENT TECHNOLOGIES INC COMMON STOCK USD.01	/etf/ea/ETZCW.djhtm?c=1&etfid=A.US&back=FHLC
DXCM	DEXCOM INC COMMON STOCK USD.001	/etf/ea/ETZCW.djhtm?c=1&etfid=DXCM.US&back=FHLC
RMD	RESMED INC COMMON STOCK USD.004	/etf/ea/ETZCW.djhtm?c=1&etfid=RMD.US&back=FHLC
ILMN	ILLUMINA INC COMMON STOCK USD.01	/etf/ea/ETZCW.djhtm?c=1&etfid=ILMN.US&back=FHLC
IDXX	IDEXX LABORATORIES INC COMMON STOCK USD.1	/etf/ea/ETZCW.djhtm?c=1&etfid=IDXX.US&back=FHLC
BAX	BAXTER INTERNATIONAL INC COMMON STOCK USD1.0	/etf/ea/ETZCW.djhtm?c=1&etfid=BAX.US&back=FHLC
BIIB	BIOGEN INC COMMON STOCK USD.0005	/etf/ea/ETZCW.djhtm?c=1&etfid=BIIB.US&back=FHLC
VEEV	VEEVA SYSTEMS INC CLASS A COMMON STOCK USD.00001	/etf/ea/ETZCW.djhtm?c=1&etfid=VEEV.US&back=FHLC
MTD	METTLER TOLEDO INTERNATIONAL COMMON STOCK USD.01	/etf/ea/ETZCW.djhtm?c=1&etfid=MTD.US&back=FHLC
ALNY	ALNYLAM PHARMACEUTICALS INC COMMON STOCK USD.01	/etf/ea/ETZCW.djhtm?c=1&etfid=ALNY.US&back=FHLC
ABC	AMERISOURCEBERGEN CORP COMMON STOCK USD.01	/etf/ea/ETZCW.djhtm?c=1&etfid=ABC.US&back=FHLC
ZBH	ZIMMER BIOMET HOLDINGS INC COMMON STOCK USD.01	/etf/ea/ETZCW.djhtm?c=1&etfid=ZBH.US&back=FHLC
WST	WEST PHARMACEUTICAL SERVICES COMMON STOCK USD.25	/etf/ea/ETZCW.djhtm?c=1&etfid=WST.US&back=FHLC
SGEN	SEAGEN INC COMMON STOCK USD.001	/etf/ea/ETZCW.djhtm?c=1&etfid=SGEN.US&back=FHLC
LH	LABORATORY CRP OF AMER HLDGS COMMON STOCK USD.1	/etf/ea/ETZCW.djhtm?c=1&etfid=LH.US&back=FHLC
STE	STERIS PLC COMMON STOCK USD75.0	/etf/ea/ETZCW.djhtm?c=1&etfid=STE.US&back=FHLC
MOH	MOLINA HEALTHCARE INC COMMON STOCK USD.001	/etf/ea/ETZCW.djhtm?c=1&etfid=MOH.US&back=FHLC
CAH	CARDINAL HEALTH INC COMMON STOCK	/etf/ea/ETZCW.djhtm?c=1&etfid=CAH.US&back=FHLC
ALGN	ALIGN TECHNOLOGY INC COMMON STOCK USD.0001	/etf/ea/ETZCW.djhtm?c=1&etfid=ALGN.US&back=FHLC
WAT	WATERS CORP COMMON STOCK USD.01	/etf/ea/ETZCW.djhtm?c=1&etfid=WAT.US&back=FHLC
PODD	INSULET CORP COMMON STOCK USD.001	/etf/ea/ETZCW.djhtm?c=1&etfid=PODD.US&back=FHLC
PKI	PERKINELMER INC COMMON STOCK USD1.0	/etf/ea/ETZCW.djhtm?c=1&etfid=PKI.US&back=FHLC
HOLX	HOLOGIC INC COMMON STOCK USD.01	/etf/ea/ETZCW.djhtm?c=1&etfid=HOLX.US&back=FHLC
BMRN	BIOMARIN PHARMACEUTICAL INC COMMON STOCK USD.001	/etf/ea/ETZCW.djhtm?c=1&etfid=BMRN.US&back=FHLC
AVTR	AVANTOR INC COMMON STOCK USD.01	/etf/ea/ETZCW.djhtm?c=1&etfid=AVTR.US&back=FHLC
CTLT	CATALENT INC COMMON STOCK USD.01	/etf/ea/ETZCW.djhtm?c=1&etfid=CTLT.US&back=FHLC
DGX	QUEST DIAGNOSTICS INC COMMON STOCK USD.01	/etf/ea/ETZCW.djhtm?c=1&etfid=DGX.US&back=FHLC
RPRX	ROYALTY PHARMA PLC  CL A COMMON STOCK	/etf/ea/ETZCW.djhtm?c=1&etfid=RPRX.US&back=FHLC
COO	COOPER COS INC/THE COMMON STOCK USD.1	/etf/ea/ETZCW.djhtm?c=1&etfid=COO.US&back=FHLC
INCY	INCYTE CORP COMMON STOCK USD.001	/etf/ea/ETZCW.djhtm?c=1&etfid=INCY.US&back=FHLC
TECH	BIO TECHNE CORP COMMON STOCK USD.01	/etf/ea/ETZCW.djhtm?c=1&etfid=TECH.US&back=FHLC
HZNP	HORIZON THERAPEUTICS PLC COMMON STOCK USD.0001	/etf/ea/ETZCW.djhtm?c=1&etfid=HZNP.US&back=FHLC
ABMD	ABIOMED INC COMMON STOCK USD.01	/etf/ea/ETZCW.djhtm?c=1&etfid=ABMD.US&back=FHLC
VTRS	VIATRIS INC COMMON STOCK	/etf/ea/ETZCW.djhtm?c=1&etfid=VTRS.US&back=FHLC
RGEN	REPLIGEN CORP COMMON STOCK USD.01	/etf/ea/ETZCW.djhtm?c=1&etfid=RGEN.US&back=FHLC
BIO	BIO RAD LABORATORIES A COMMON STOCK USD.0001	/etf/ea/ETZCW.djhtm?c=1&etfid=BIO.US&back=FHLC
SWAV	SHOCKWAVE MEDICAL INC COMMON STOCK USD.001	/etf/ea/ETZCW.djhtm?c=1&etfid=SWAV.US&back=FHLC
TFX	TELEFLEX INC COMMON STOCK USD1.0	/etf/ea/ETZCW.djhtm?c=1&etfid=TFX.US&back=FHLC
CRL	CHARLES RIVER LABORATORIES COMMON STOCK USD.01	/etf/ea/ETZCW.djhtm?c=1&etfid=CRL.US&back=FHLC
UTHR	UNITED THERAPEUTICS CORP COMMON STOCK USD.01	/etf/ea/ETZCW.djhtm?c=1&etfid=UTHR.US&back=FHLC
HSIC	HENRY SCHEIN INC COMMON STOCK USD.01	/etf/ea/ETZCW.djhtm?c=1&etfid=HSIC.US&back=FHLC
NBIX	NEUROCRINE BIOSCIENCES INC COMMON STOCK USD.001	/etf/ea/ETZCW.djhtm?c=1&etfid=NBIX.US&back=FHLC
JAZZ	JAZZ PHARMACEUTICALS PLC COMMON STOCK USD.0001	/etf/ea/ETZCW.djhtm?c=1&etfid=JAZZ.US&back=FHLC
SRPT	SAREPTA THERAPEUTICS INC COMMON STOCK USD.0001	/etf/ea/ETZCW.djhtm?c=1&etfid=SRPT.US&back=FHLC
BHVN	BIOHAVEN PHARMACEUTICAL HOLD COMMON STOCK	/etf/ea/ETZCW.djhtm?c=1&etfid=BHVN.US&back=FHLC
MASI	MASIMO CORP COMMON STOCK USD.001	/etf/ea/ETZCW.djhtm?c=1&etfid=MASI.US&back=FHLC
NVCR	NOVOCURE LTD COMMON STOCK	/etf/ea/ETZCW.djhtm?c=1&etfid=NVCR.US&back=FHLC
AAIC	SS INST TREAS PLUS MM FUND TRU SS INST TREAS PLUS MM FUND TR	/etf/ea/ETZCW.djhtm?c=1&etfid=AAIC.US&back=FHLC
ACHC	ACADIA HEALTHCARE CO INC COMMON STOCK USD.01	/etf/ea/ETZCW.djhtm?c=1&etfid=ACHC.US&back=FHLC
OGN	ORGANON + CO COMMON STOCK USD.01	/etf/ea/ETZCW.djhtm?c=1&etfid=OGN.US&back=FHLC
CHE	CHEMED CORP COMMON STOCK USD1.0	/etf/ea/ETZCW.djhtm?c=1&etfid=CHE.US&back=FHLC
XRAY	DENTSPLY SIRONA INC COMMON STOCK USD.01	/etf/ea/ETZCW.djhtm?c=1&etfid=XRAY.US&back=FHLC
KRTX	KARUNA THERAPEUTICS INC COMMON STOCK USD.00001	/etf/ea/ETZCW.djhtm?c=1&etfid=KRTX.US&back=FHLC
UHS	UNIVERSAL HEALTH SERVICES B COMMON STOCK USD.01	/etf/ea/ETZCW.djhtm?c=1&etfid=UHS.US&back=FHLC
ELAN	ELANCO ANIMAL HEALTH INC COMMON STOCK	/etf/ea/ETZCW.djhtm?c=1&etfid=ELAN.US&back=FHLC
	CHANGE HEALTHCARE INC COMMON STOCK USD.001	
EXAS	EXACT SCIENCES CORP COMMON STOCK USD.01	/etf/ea/ETZCW.djhtm?c=1&etfid=EXAS.US&back=FHLC
SYNH	SYNEOS HEALTH INC COMMON STOCK USD.01	/etf/ea/ETZCW.djhtm?c=1&etfid=SYNH.US&back=FHLC
NVST	ENVISTA HOLDINGS CORP COMMON STOCK USD.01	/etf/ea/ETZCW.djhtm?c=1&etfid=NVST.US&back=FHLC
PEN	PENUMBRA INC COMMON STOCK USD.001	/etf/ea/ETZCW.djhtm?c=1&etfid=PEN.US&back=FHLC
BRKR	BRUKER CORP COMMON STOCK USD.01	/etf/ea/ETZCW.djhtm?c=1&etfid=BRKR.US&back=FHLC
THC	TENET HEALTHCARE CORP COMMON STOCK USD.05	/etf/ea/ETZCW.djhtm?c=1&etfid=THC.US&back=FHLC
EXEL	EXELIXIS INC COMMON STOCK USD.001	/etf/ea/ETZCW.djhtm?c=1&etfid=EXEL.US&back=FHLC
HALO	HALOZYME THERAPEUTICS INC COMMON STOCK USD.001	/etf/ea/ETZCW.djhtm?c=1&etfid=HALO.US&back=FHLC
HQY	HEALTHEQUITY INC COMMON STOCK USD.0001	/etf/ea/ETZCW.djhtm?c=1&etfid=HQY.US&back=FHLC
IONS	IONIS PHARMACEUTICALS INC COMMON STOCK USD.001	/etf/ea/ETZCW.djhtm?c=1&etfid=IONS.US&back=FHLC
LNTH	LANTHEUS HOLDINGS INC COMMON STOCK USD.01	/etf/ea/ETZCW.djhtm?c=1&etfid=LNTH.US&back=FHLC
INSP	INSPIRE MEDICAL SYSTEMS INC COMMON STOCK USD.001	/etf/ea/ETZCW.djhtm?c=1&etfid=INSP.US&back=FHLC
APLS	APELLIS PHARMACEUTICALS INC COMMON STOCK USD.0001	/etf/ea/ETZCW.djhtm?c=1&etfid=APLS.US&back=FHLC
PRGO	PERRIGO CO PLC COMMON STOCK EUR.001	/etf/ea/ETZCW.djhtm?c=1&etfid=PRGO.US&back=FHLC
TDOC	TELADOC HEALTH INC COMMON STOCK USD.001	/etf/ea/ETZCW.djhtm?c=1&etfid=TDOC.US&back=FHLC
DVA	DAVITA INC COMMON STOCK USD.001	/etf/ea/ETZCW.djhtm?c=1&etfid=DVA.US&back=FHLC
EHC	ENCOMPASS HEALTH CORP COMMON STOCK USD.01	/etf/ea/ETZCW.djhtm?c=1&etfid=EHC.US&back=FHLC
CRSP	CRISPR THERAPEUTICS AG COMMON STOCK CHF.03	/etf/ea/ETZCW.djhtm?c=1&etfid=CRSP.US&back=FHLC
LHCG	LHC GROUP INC COMMON STOCK USD.01	/etf/ea/ETZCW.djhtm?c=1&etfid=LHCG.US&back=FHLC
GMED	GLOBUS MEDICAL INC   A COMMON STOCK USD.001	/etf/ea/ETZCW.djhtm?c=1&etfid=GMED.US&back=FHLC
GH	GUARDANT HEALTH INC COMMON STOCK USD.00001	/etf/ea/ETZCW.djhtm?c=1&etfid=GH.US&back=FHLC
AMN	AMN HEALTHCARE SERVICES INC COMMON STOCK USD.01	/etf/ea/ETZCW.djhtm?c=1&etfid=AMN.US&back=FHLC
OMCL	OMNICELL INC COMMON STOCK USD.001	/etf/ea/ETZCW.djhtm?c=1&etfid=OMCL.US&back=FHLC
NTRA	NATERA INC COMMON STOCK USD.0001	/etf/ea/ETZCW.djhtm?c=1&etfid=NTRA.US&back=FHLC
OPCH	OPTION CARE HEALTH INC COMMON STOCK USD.0001	/etf/ea/ETZCW.djhtm?c=1&etfid=OPCH.US&back=FHLC
ENSG	ENSIGN GROUP INC/THE COMMON STOCK USD.001	/etf/ea/ETZCW.djhtm?c=1&etfid=ENSG.US&back=FHLC
IRTC	IRHYTHM TECHNOLOGIES INC COMMON STOCK USD.001	/etf/ea/ETZCW.djhtm?c=1&etfid=IRTC.US&back=FHLC
BPMC	BLUEPRINT MEDICINES CORP COMMON STOCK USD.001	/etf/ea/ETZCW.djhtm?c=1&etfid=BPMC.US&back=FHLC
CYTK	CYTOKINETICS INC COMMON STOCK USD.001	/etf/ea/ETZCW.djhtm?c=1&etfid=CYTK.US&back=FHLC
ITCI	INTRA CELLULAR THERAPIES INC COMMON STOCK USD.0001	/etf/ea/ETZCW.djhtm?c=1&etfid=ITCI.US&back=FHLC
AGL	AGILON HEALTH INC COMMON STOCK USD.01	/etf/ea/ETZCW.djhtm?c=1&etfid=AGL.US&back=FHLC
	GLOBAL BLOOD THERAPEUTICS IN COMMON STOCK USD.001	
PINC	PREMIER INC CLASS A COMMON STOCK USD.01	/etf/ea/ETZCW.djhtm?c=1&etfid=PINC.US&back=FHLC
NTLA	INTELLIA THERAPEUTICS INC COMMON STOCK USD.0001	/etf/ea/ETZCW.djhtm?c=1&etfid=NTLA.US&back=FHLC
ARWR	ARROWHEAD PHARMACEUTICALS IN COMMON STOCK USD.001	/etf/ea/ETZCW.djhtm?c=1&etfid=ARWR.US&back=FHLC
QDEL	QUIDELORTHO CORP COMMON STOCK USD.001	/etf/ea/ETZCW.djhtm?c=1&etfid=QDEL.US&back=FHLC
AZTA	AZENTA INC COMMON STOCK USD.01	/etf/ea/ETZCW.djhtm?c=1&etfid=AZTA.US&back=FHLC
ALKS	ALKERMES PLC COMMON STOCK USD.01	/etf/ea/ETZCW.djhtm?c=1&etfid=ALKS.US&back=FHLC
STAA	STAAR SURGICAL CO COMMON STOCK USD.01	/etf/ea/ETZCW.djhtm?c=1&etfid=STAA.US&back=FHLC
AMED	AMEDISYS INC COMMON STOCK USD.001	/etf/ea/ETZCW.djhtm?c=1&etfid=AMED.US&back=FHLC
HAE	HAEMONETICS CORP/MASS COMMON STOCK USD.01	/etf/ea/ETZCW.djhtm?c=1&etfid=HAE.US&back=FHLC
MEDP	MEDPACE HOLDINGS INC COMMON STOCK USD.01	/etf/ea/ETZCW.djhtm?c=1&etfid=MEDP.US&back=FHLC
IART	INTEGRA LIFESCIENCES HOLDING COMMON STOCK USD.01	/etf/ea/ETZCW.djhtm?c=1&etfid=IART.US&back=FHLC
MMSI	MERIT MEDICAL SYSTEMS INC COMMON STOCK	/etf/ea/ETZCW.djhtm?c=1&etfid=MMSI.US&back=FHLC
PTCT	PTC THERAPEUTICS INC COMMON STOCK USD.001	/etf/ea/ETZCW.djhtm?c=1&etfid=PTCT.US&back=FHLC
ICUI	ICU MEDICAL INC COMMON STOCK USD.1	/etf/ea/ETZCW.djhtm?c=1&etfid=ICUI.US&back=FHLC
RARE	ULTRAGENYX PHARMACEUTICAL IN COMMON STOCK USD.001	/etf/ea/ETZCW.djhtm?c=1&etfid=RARE.US&back=FHLC
MRTX	MIRATI THERAPEUTICS INC COMMON STOCK	/etf/ea/ETZCW.djhtm?c=1&etfid=MRTX.US&back=FHLC
BEAM	BEAM THERAPEUTICS INC COMMON STOCK USD.01	/etf/ea/ETZCW.djhtm?c=1&etfid=BEAM.US&back=FHLC
RCM	R1 RCM INC COMMON STOCK USD.01	/etf/ea/ETZCW.djhtm?c=1&etfid=RCM.US&back=FHLC
PRVA	PRIVIA HEALTH GROUP INC COMMON STOCK USD.01	/etf/ea/ETZCW.djhtm?c=1&etfid=PRVA.US&back=FHLC
LIVN	LIVANOVA PLC COMMON STOCK GBP1.0	/etf/ea/ETZCW.djhtm?c=1&etfid=LIVN.US&back=FHLC
INSM	INSMED INC COMMON STOCK USD.01	/etf/ea/ETZCW.djhtm?c=1&etfid=INSM.US&back=FHLC
PGNY	PROGYNY INC COMMON STOCK USD.0001	/etf/ea/ETZCW.djhtm?c=1&etfid=PGNY.US&back=FHLC
NARI	INARI MEDICAL INC COMMON STOCK USD.001	/etf/ea/ETZCW.djhtm?c=1&etfid=NARI.US&back=FHLC
CCXI	CHEMOCENTRYX INC COMMON STOCK USD.001	/etf/ea/ETZCW.djhtm?c=1&etfid=CCXI.US&back=FHLC
TNDM	TANDEM DIABETES CARE INC COMMON STOCK	/etf/ea/ETZCW.djhtm?c=1&etfid=TNDM.US&back=FHLC
SEM	SELECT MEDICAL HOLDINGS CORP COMMON STOCK USD.001	/etf/ea/ETZCW.djhtm?c=1&etfid=SEM.US&back=FHLC
EVH	EVOLENT HEALTH INC   A COMMON STOCK USD.01	/etf/ea/ETZCW.djhtm?c=1&etfid=EVH.US&back=FHLC
OSH	OAK STREET HEALTH INC COMMON STOCK USD.001	/etf/ea/ETZCW.djhtm?c=1&etfid=OSH.US&back=FHLC
TXG	10X GENOMICS INC CLASS A COMMON STOCK	/etf/ea/ETZCW.djhtm?c=1&etfid=TXG.US&back=FHLC
AXNX	AXONICS INC COMMON STOCK USD.0001	/etf/ea/ETZCW.djhtm?c=1&etfid=AXNX.US&back=FHLC
CNMD	CONMED CORP COMMON STOCK USD.01	/etf/ea/ETZCW.djhtm?c=1&etfid=CNMD.US&back=FHLC
NVAX	NOVAVAX INC COMMON STOCK USD.01	/etf/ea/ETZCW.djhtm?c=1&etfid=NVAX.US&back=FHLC
BCRX	BIOCRYST PHARMACEUTICALS INC COMMON STOCK USD.01	/etf/ea/ETZCW.djhtm?c=1&etfid=BCRX.US&back=FHLC
PBH	PRESTIGE CONSUMER HEALTHCARE COMMON STOCK USD.01	/etf/ea/ETZCW.djhtm?c=1&etfid=PBH.US&back=FHLC
ENOV	ENOVIS CORP COMMON STOCK USD.001	/etf/ea/ETZCW.djhtm?c=1&etfid=ENOV.US&back=FHLC
PDCO	PATTERSON COS INC COMMON STOCK USD.01	/etf/ea/ETZCW.djhtm?c=1&etfid=PDCO.US&back=FHLC
CORT	CORCEPT THERAPEUTICS INC COMMON STOCK USD.001	/etf/ea/ETZCW.djhtm?c=1&etfid=CORT.US&back=FHLC
DNLI	DENALI THERAPEUTICS INC COMMON STOCK USD.01	/etf/ea/ETZCW.djhtm?c=1&etfid=DNLI.US&back=FHLC
PCRX	PACIRA BIOSCIENCES INC COMMON STOCK USD.001	/etf/ea/ETZCW.djhtm?c=1&etfid=PCRX.US&back=FHLC
ONEM	1LIFE HEALTHCARE INC COMMON STOCK USD.001	/etf/ea/ETZCW.djhtm?c=1&etfid=ONEM.US&back=FHLC
FOLD	AMICUS THERAPEUTICS INC COMMON STOCK USD.01	/etf/ea/ETZCW.djhtm?c=1&etfid=FOLD.US&back=FHLC
CVET	COVETRUS INC COMMON STOCK	/etf/ea/ETZCW.djhtm?c=1&etfid=CVET.US&back=FHLC
MRVI	MARAVAI LIFESCIENCES HLDGS A COMMON STOCK USD.01	/etf/ea/ETZCW.djhtm?c=1&etfid=MRVI.US&back=FHLC
GKOS	GLAUKOS CORP COMMON STOCK USD.001	/etf/ea/ETZCW.djhtm?c=1&etfid=GKOS.US&back=FHLC
NEOG	NEOGEN CORP COMMON STOCK USD.16	/etf/ea/ETZCW.djhtm?c=1&etfid=NEOG.US&back=FHLC
NUVA	NUVASIVE INC COMMON STOCK USD.001	/etf/ea/ETZCW.djhtm?c=1&etfid=NUVA.US&back=FHLC
OMI	OWENS + MINOR INC COMMON STOCK USD2.0	/etf/ea/ETZCW.djhtm?c=1&etfid=OMI.US&back=FHLC
TWST	TWIST BIOSCIENCE CORP COMMON STOCK USD.00001	/etf/ea/ETZCW.djhtm?c=1&etfid=TWST.US&back=FHLC
ITGR	INTEGER HOLDINGS CORP COMMON STOCK USD.001	/etf/ea/ETZCW.djhtm?c=1&etfid=ITGR.US&back=FHLC
FATE	FATE THERAPEUTICS INC COMMON STOCK USD.001	/etf/ea/ETZCW.djhtm?c=1&etfid=FATE.US&back=FHLC
SAGE	SAGE THERAPEUTICS INC COMMON STOCK USD.0001	/etf/ea/ETZCW.djhtm?c=1&etfid=SAGE.US&back=FHLC
ATRC	ATRICURE INC COMMON STOCK USD.001	/etf/ea/ETZCW.djhtm?c=1&etfid=ATRC.US&back=FHLC
ACAD	ACADIA PHARMACEUTICALS INC COMMON STOCK USD.0001	/etf/ea/ETZCW.djhtm?c=1&etfid=ACAD.US&back=FHLC
SGFY	SIGNIFY HEALTH INC  CLASS A COMMON STOCK USD.01	/etf/ea/ETZCW.djhtm?c=1&etfid=SGFY.US&back=FHLC
MDRX	ALLSCRIPTS HEALTHCARE SOLUTI COMMON STOCK USD.01	/etf/ea/ETZCW.djhtm?c=1&etfid=MDRX.US&back=FHLC
TLRY	TILRAY BRANDS INC COMMON STOCK USD.0001	/etf/ea/ETZCW.djhtm?c=1&etfid=TLRY.US&back=FHLC
ARVN	ARVINAS INC COMMON STOCK USD.001	/etf/ea/ETZCW.djhtm?c=1&etfid=ARVN.US&back=FHLC
AXSM	AXSOME THERAPEUTICS INC COMMON STOCK USD.0001	/etf/ea/ETZCW.djhtm?c=1&etfid=AXSM.US&back=FHLC
EMBC	EMBECTA CORP COMMON STOCK USD.01	/etf/ea/ETZCW.djhtm?c=1&etfid=EMBC.US&back=FHLC
SUPN	SUPERNUS PHARMACEUTICALS INC COMMON STOCK USD.001	/etf/ea/ETZCW.djhtm?c=1&etfid=SUPN.US&back=FHLC
XENE	XENON PHARMACEUTICALS INC COMMON STOCK	/etf/ea/ETZCW.djhtm?c=1&etfid=XENE.US&back=FHLC
MYGN	MYRIAD GENETICS INC COMMON STOCK USD.01	/etf/ea/ETZCW.djhtm?c=1&etfid=MYGN.US&back=FHLC
CERE	CEREVEL THERAPEUTICS HOLDING COMMON STOCK USD.0001	/etf/ea/ETZCW.djhtm?c=1&etfid=CERE.US&back=FHLC
VIR	VIR BIOTECHNOLOGY INC COMMON STOCK	/etf/ea/ETZCW.djhtm?c=1&etfid=VIR.US&back=FHLC
AMEH	APOLLO MEDICAL HOLDINGS INC COMMON STOCK USD.001	/etf/ea/ETZCW.djhtm?c=1&etfid=AMEH.US&back=FHLC
SHC	SOTERA HEALTH CO COMMON STOCK USD.01	/etf/ea/ETZCW.djhtm?c=1&etfid=SHC.US&back=FHLC
CERT	CERTARA INC COMMON STOCK USD.01	/etf/ea/ETZCW.djhtm?c=1&etfid=CERT.US&back=FHLC
CYRX	CRYOPORT INC COMMON STOCK USD.001	/etf/ea/ETZCW.djhtm?c=1&etfid=CYRX.US&back=FHLC
SDGR	SCHRODINGER INC COMMON STOCK USD.01	/etf/ea/ETZCW.djhtm?c=1&etfid=SDGR.US&back=FHLC
TMDX	TRANSMEDICS GROUP INC COMMON STOCK	/etf/ea/ETZCW.djhtm?c=1&etfid=TMDX.US&back=FHLC
LGND	LIGAND PHARMACEUTICALS COMMON STOCK USD.001	/etf/ea/ETZCW.djhtm?c=1&etfid=LGND.US&back=FHLC
IRWD	IRONWOOD PHARMACEUTICALS INC COMMON STOCK USD.001	/etf/ea/ETZCW.djhtm?c=1&etfid=IRWD.US&back=FHLC
NVRO	NEVRO CORP COMMON STOCK USD.001	/etf/ea/ETZCW.djhtm?c=1&etfid=NVRO.US&back=FHLC
	US DOLLAR	
CRVL	CORVEL CORP COMMON STOCK USD.0001	/etf/ea/ETZCW.djhtm?c=1&etfid=CRVL.US&back=FHLC
RLAY	RELAY THERAPEUTICS INC COMMON STOCK	/etf/ea/ETZCW.djhtm?c=1&etfid=RLAY.US&back=FHLC
MD	PEDIATRIX MEDICAL GROUP INC COMMON STOCK USD.01	/etf/ea/ETZCW.djhtm?c=1&etfid=MD.US&back=FHLC
XNCR	XENCOR INC COMMON STOCK USD.01	/etf/ea/ETZCW.djhtm?c=1&etfid=XNCR.US&back=FHLC
ADUS	ADDUS HOMECARE CORP COMMON STOCK USD.001	/etf/ea/ETZCW.djhtm?c=1&etfid=ADUS.US&back=FHLC
VCYT	VERACYTE INC COMMON STOCK USD.001	/etf/ea/ETZCW.djhtm?c=1&etfid=VCYT.US&back=FHLC
VIVO	MERIDIAN BIOSCIENCE INC COMMON STOCK	/etf/ea/ETZCW.djhtm?c=1&etfid=VIVO.US&back=FHLC
TVTX	TRAVERE THERAPEUTICS INC COMMON STOCK USD.0001	/etf/ea/ETZCW.djhtm?c=1&etfid=TVTX.US&back=FHLC
RVNC	REVANCE THERAPEUTICS INC COMMON STOCK USD.001	/etf/ea/ETZCW.djhtm?c=1&etfid=RVNC.US&back=FHLC
SILK	SILK ROAD MEDICAL INC COMMON STOCK USD.001	/etf/ea/ETZCW.djhtm?c=1&etfid=SILK.US&back=FHLC
DVAX	DYNAVAX TECHNOLOGIES CORP COMMON STOCK USD.001	/etf/ea/ETZCW.djhtm?c=1&etfid=DVAX.US&back=FHLC
MODV	MODIVCARE INC COMMON STOCK USD.001	/etf/ea/ETZCW.djhtm?c=1&etfid=MODV.US&back=FHLC
CPRX	CATALYST PHARMACEUTICALS INC COMMON STOCK USD.001	/etf/ea/ETZCW.djhtm?c=1&etfid=CPRX.US&back=FHLC
PHR	PHREESIA INC COMMON STOCK USD.01	/etf/ea/ETZCW.djhtm?c=1&etfid=PHR.US&back=FHLC
ALHC	ALIGNMENT HEALTHCARE INC COMMON STOCK USD.001	/etf/ea/ETZCW.djhtm?c=1&etfid=ALHC.US&back=FHLC
KRYS	KRYSTAL BIOTECH INC COMMON STOCK USD.00001	/etf/ea/ETZCW.djhtm?c=1&etfid=KRYS.US&back=FHLC
IOVA	IOVANCE BIOTHERAPEUTICS INC COMMON STOCK USD.000041666	/etf/ea/ETZCW.djhtm?c=1&etfid=IOVA.US&back=FHLC
AGIO	AGIOS PHARMACEUTICALS INC COMMON STOCK USD.001	/etf/ea/ETZCW.djhtm?c=1&etfid=AGIO.US&back=FHLC
RVMD	REVOLUTION MEDICINES INC COMMON STOCK	/etf/ea/ETZCW.djhtm?c=1&etfid=RVMD.US&back=FHLC
VERV	VERVE THERAPEUTICS INC COMMON STOCK USD.001	/etf/ea/ETZCW.djhtm?c=1&etfid=VERV.US&back=FHLC
PACB	PACIFIC BIOSCIENCES OF CALIF COMMON STOCK USD.0001	/etf/ea/ETZCW.djhtm?c=1&etfid=PACB.US&back=FHLC
AHCO	ADAPTHEALTH CORP COMMON STOCK	/etf/ea/ETZCW.djhtm?c=1&etfid=AHCO.US&back=FHLC
ESTA	ESTABLISHMENT LABS HOLDINGS COMMON STOCK USD1.0	/etf/ea/ETZCW.djhtm?c=1&etfid=ESTA.US&back=FHLC
ZNTL	ZENTALIS PHARMACEUTICALS INC COMMON STOCK USD.001	/etf/ea/ETZCW.djhtm?c=1&etfid=ZNTL.US&back=FHLC
ENTA	ENANTA PHARMACEUTICALS INC COMMON STOCK USD.01	/etf/ea/ETZCW.djhtm?c=1&etfid=ENTA.US&back=FHLC
ALLO	ALLOGENE THERAPEUTICS INC COMMON STOCK USD.001	/etf/ea/ETZCW.djhtm?c=1&etfid=ALLO.US&back=FHLC
AVNS	AVANOS MEDICAL INC COMMON STOCK USD.01	/etf/ea/ETZCW.djhtm?c=1&etfid=AVNS.US&back=FHLC
NEO	NEOGENOMICS INC COMMON STOCK USD.001	/etf/ea/ETZCW.djhtm?c=1&etfid=NEO.US&back=FHLC
IMGN	IMMUNOGEN INC COMMON STOCK USD.01	/etf/ea/ETZCW.djhtm?c=1&etfid=IMGN.US&back=FHLC
AMPH	AMPHASTAR PHARMACEUTICALS IN COMMON STOCK USD.0001	/etf/ea/ETZCW.djhtm?c=1&etfid=AMPH.US&back=FHLC
CLDX	CELLDEX THERAPEUTICS INC COMMON STOCK USD.001	/etf/ea/ETZCW.djhtm?c=1&etfid=CLDX.US&back=FHLC
SNDX	SYNDAX PHARMACEUTICALS INC COMMON STOCK USD.0001	/etf/ea/ETZCW.djhtm?c=1&etfid=SNDX.US&back=FHLC
FGEN	FIBROGEN INC COMMON STOCK USD.01	/etf/ea/ETZCW.djhtm?c=1&etfid=FGEN.US&back=FHLC
ARQT	ARCUTIS BIOTHERAPEUTICS INC COMMON STOCK USD.0001	/etf/ea/ETZCW.djhtm?c=1&etfid=ARQT.US&back=FHLC
SGRY	SURGERY PARTNERS INC COMMON STOCK USD.01	/etf/ea/ETZCW.djhtm?c=1&etfid=SGRY.US&back=FHLC
EBS	EMERGENT BIOSOLUTIONS INC COMMON STOCK USD.001	/etf/ea/ETZCW.djhtm?c=1&etfid=EBS.US&back=FHLC
USPH	U.S. PHYSICAL THERAPY INC COMMON STOCK USD.01	/etf/ea/ETZCW.djhtm?c=1&etfid=USPH.US&back=FHLC
RGNX	REGENXBIO INC COMMON STOCK USD.0001	/etf/ea/ETZCW.djhtm?c=1&etfid=RGNX.US&back=FHLC
VCEL	VERICEL CORP COMMON STOCK	/etf/ea/ETZCW.djhtm?c=1&etfid=VCEL.US&back=FHLC
CDNA	CAREDX INC COMMON STOCK USD.001	/etf/ea/ETZCW.djhtm?c=1&etfid=CDNA.US&back=FHLC
CDMO	AVID BIOSERVICES INC COMMON STOCK USD.001	/etf/ea/ETZCW.djhtm?c=1&etfid=CDMO.US&back=FHLC
RCUS	ARCUS BIOSCIENCES INC COMMON STOCK USD.0001	/etf/ea/ETZCW.djhtm?c=1&etfid=RCUS.US&back=FHLC
RDNT	RADNET INC COMMON STOCK USD.0001	/etf/ea/ETZCW.djhtm?c=1&etfid=RDNT.US&back=FHLC
HRMY	HARMONY BIOSCIENCES HOLDINGS COMMON STOCK USD.00001	/etf/ea/ETZCW.djhtm?c=1&etfid=HRMY.US&back=FHLC
NHC	NATIONAL HEALTHCARE CORP COMMON STOCK USD.01	/etf/ea/ETZCW.djhtm?c=1&etfid=NHC.US&back=FHLC
LMAT	LEMAITRE VASCULAR INC COMMON STOCK USD.01	/etf/ea/ETZCW.djhtm?c=1&etfid=LMAT.US&back=FHLC
NXGN	NEXTGEN HEALTHCARE INC COMMON STOCK USD.01	/etf/ea/ETZCW.djhtm?c=1&etfid=NXGN.US&back=FHLC
EDIT	EDITAS MEDICINE INC COMMON STOCK USD.0001	/etf/ea/ETZCW.djhtm?c=1&etfid=EDIT.US&back=FHLC
ROIV	ROIVANT SCIENCES LTD COMMON STOCK	/etf/ea/ETZCW.djhtm?c=1&etfid=ROIV.US&back=FHLC
SAVA	CASSAVA SCIENCES INC COMMON STOCK USD.001	/etf/ea/ETZCW.djhtm?c=1&etfid=SAVA.US&back=FHLC
TGTX	TG THERAPEUTICS INC COMMON STOCK USD.001	/etf/ea/ETZCW.djhtm?c=1&etfid=TGTX.US&back=FHLC
OPK	OPKO HEALTH INC COMMON STOCK USD.01	/etf/ea/ETZCW.djhtm?c=1&etfid=OPK.US&back=FHLC
KYMR	KYMERA THERAPEUTICS INC COMMON STOCK	/etf/ea/ETZCW.djhtm?c=1&etfid=KYMR.US&back=FHLC
SLP	SIMULATIONS PLUS INC COMMON STOCK USD.001	/etf/ea/ETZCW.djhtm?c=1&etfid=SLP.US&back=FHLC
HSKA	HESKA CORP COMMON STOCK USD.001	/etf/ea/ETZCW.djhtm?c=1&etfid=HSKA.US&back=FHLC
PCVX	VAXCYTE INC COMMON STOCK USD.001	/etf/ea/ETZCW.djhtm?c=1&etfid=PCVX.US&back=FHLC
MLAB	MESA LABORATORIES INC COMMON STOCK	/etf/ea/ETZCW.djhtm?c=1&etfid=MLAB.US&back=FHLC
RYTM	RHYTHM PHARMACEUTICALS INC COMMON STOCK	/etf/ea/ETZCW.djhtm?c=1&etfid=RYTM.US&back=FHLC
CCRN	CROSS COUNTRY HEALTHCARE INC COMMON STOCK USD.0001	/etf/ea/ETZCW.djhtm?c=1&etfid=CCRN.US&back=FHLC
ADPT	ADAPTIVE BIOTECHNOLOGIES COMMON STOCK USD.0001	/etf/ea/ETZCW.djhtm?c=1&etfid=ADPT.US&back=FHLC
AUPH	AURINIA PHARMACEUTICALS INC COMMON STOCK	/etf/ea/ETZCW.djhtm?c=1&etfid=AUPH.US&back=FHLC
GERN	GERON CORP COMMON STOCK USD.001	/etf/ea/ETZCW.djhtm?c=1&etfid=GERN.US&back=FHLC
CANO	CANO HEALTH INC COMMON STOCK USD.0001	/etf/ea/ETZCW.djhtm?c=1&etfid=CANO.US&back=FHLC
PRTA	PROTHENA CORP PLC COMMON STOCK USD.01	/etf/ea/ETZCW.djhtm?c=1&etfid=PRTA.US&back=FHLC
AMWL	AMERICAN WELL CORP CLASS A COMMON STOCK USD.01	/etf/ea/ETZCW.djhtm?c=1&etfid=AMWL.US&back=FHLC
AORT	ARTIVION INC COMMON STOCK USD.01	/etf/ea/ETZCW.djhtm?c=1&etfid=AORT.US&back=FHLC
ANGO	ANGIODYNAMICS INC COMMON STOCK USD.01	/etf/ea/ETZCW.djhtm?c=1&etfid=ANGO.US&back=FHLC
MNKD	MANNKIND CORP COMMON STOCK USD.01	/etf/ea/ETZCW.djhtm?c=1&etfid=MNKD.US&back=FHLC
CLOV	CLOVER HEALTH INVESTMENTS CO COMMON STOCK USD.0001	/etf/ea/ETZCW.djhtm?c=1&etfid=CLOV.US&back=FHLC
MDGL	MADRIGAL PHARMACEUTICALS INC COMMON STOCK USD.0001	/etf/ea/ETZCW.djhtm?c=1&etfid=MDGL.US&back=FHLC
ATRI	ATRION CORPORATION COMMON STOCK USD.1	/etf/ea/ETZCW.djhtm?c=1&etfid=ATRI.US&back=FHLC
FLGT	FULGENT GENETICS INC COMMON STOCK USD.0001	/etf/ea/ETZCW.djhtm?c=1&etfid=FLGT.US&back=FHLC
ME	23ANDME HOLDING CO  CLASS A COMMON STOCK USD.0001	/etf/ea/ETZCW.djhtm?c=1&etfid=ME.US&back=FHLC
FIGS	FIGS INC CLASS A COMMON STOCK USD.0001	/etf/ea/ETZCW.djhtm?c=1&etfid=FIGS.US&back=FHLC
EHAB	ENHABIT INC COMMON STOCK USD.01	/etf/ea/ETZCW.djhtm?c=1&etfid=EHAB.US&back=FHLC
VREX	VAREX IMAGING CORP COMMON STOCK USD.01	/etf/ea/ETZCW.djhtm?c=1&etfid=VREX.US&back=FHLC
KDNY	CHINOOK THERAPEUTICS INC COMMON STOCK USD.0001	/etf/ea/ETZCW.djhtm?c=1&etfid=KDNY.US&back=FHLC
INVA	INNOVIVA INC COMMON STOCK USD.01	/etf/ea/ETZCW.djhtm?c=1&etfid=INVA.US&back=FHLC
DCGO	DOCGO INC COMMON STOCK USD.0001	/etf/ea/ETZCW.djhtm?c=1&etfid=DCGO.US&back=FHLC
QURE	UNIQURE NV COMMON STOCK EUR.05	/etf/ea/ETZCW.djhtm?c=1&etfid=QURE.US&back=FHLC
SRNE	SORRENTO THERAPEUTICS INC COMMON STOCK USD.0001	/etf/ea/ETZCW.djhtm?c=1&etfid=SRNE.US&back=FHLC
ISEE	IVERIC BIO INC COMMON STOCK USD.001	/etf/ea/ETZCW.djhtm?c=1&etfid=ISEE.US&back=FHLC
CTKB	CYTEK BIOSCIENCES INC COMMON STOCK USD.001	/etf/ea/ETZCW.djhtm?c=1&etfid=CTKB.US&back=FHLC
KURA	KURA ONCOLOGY INC COMMON STOCK USD.0001	/etf/ea/ETZCW.djhtm?c=1&etfid=KURA.US&back=FHLC
ACRS	ACLARIS THERAPEUTICS INC COMMON STOCK USD.00001	/etf/ea/ETZCW.djhtm?c=1&etfid=ACRS.US&back=FHLC
AVXL	ANAVEX LIFE SCIENCES CORP COMMON STOCK USD.001	/etf/ea/ETZCW.djhtm?c=1&etfid=AVXL.US&back=FHLC
SWTX	SPRINGWORKS THERAPEUTICS INC COMMON STOCK USD.0001	/etf/ea/ETZCW.djhtm?c=1&etfid=SWTX.US&back=FHLC
HIMS	HIMS + HERS HEALTH INC COMMON STOCK USD.0001	/etf/ea/ETZCW.djhtm?c=1&etfid=HIMS.US&back=FHLC
NKTR	NEKTAR THERAPEUTICS COMMON STOCK USD.0001	/etf/ea/ETZCW.djhtm?c=1&etfid=NKTR.US&back=FHLC
BNGO	BIONANO GENOMICS INC COMMON STOCK USD.0001	/etf/ea/ETZCW.djhtm?c=1&etfid=BNGO.US&back=FHLC
BLFS	BIOLIFE SOLUTIONS INC COMMON STOCK USD.001	/etf/ea/ETZCW.djhtm?c=1&etfid=BLFS.US&back=FHLC
RNA	AVIDITY BIOSCIENCES INC COMMON STOCK	/etf/ea/ETZCW.djhtm?c=1&etfid=RNA.US&back=FHLC
OM	OUTSET MEDICAL INC COMMON STOCK USD.001	/etf/ea/ETZCW.djhtm?c=1&etfid=OM.US&back=FHLC
MYOV	MYOVANT SCIENCES LTD COMMON STOCK USD.000017727	/etf/ea/ETZCW.djhtm?c=1&etfid=MYOV.US&back=FHLC
KIDS	ORTHOPEDIATRICS CORP COMMON STOCK USD.00025	/etf/ea/ETZCW.djhtm?c=1&etfid=KIDS.US&back=FHLC
BKD	BROOKDALE SENIOR LIVING INC COMMON STOCK USD.01	/etf/ea/ETZCW.djhtm?c=1&etfid=BKD.US&back=FHLC
CRNX	CRINETICS PHARMACEUTICALS IN COMMON STOCK USD.001	/etf/ea/ETZCW.djhtm?c=1&etfid=CRNX.US&back=FHLC
GOSS	GOSSAMER BIO INC COMMON STOCK USD.0001	/etf/ea/ETZCW.djhtm?c=1&etfid=GOSS.US&back=FHLC
	HANGER INC COMMON STOCK USD.01	
EQRX	EQRX INC COMMON STOCK USD.0001	/etf/ea/ETZCW.djhtm?c=1&etfid=EQRX.US&back=FHLC
CUTR	CUTERA INC COMMON STOCK USD.001	/etf/ea/ETZCW.djhtm?c=1&etfid=CUTR.US&back=FHLC
CERS	CERUS CORP COMMON STOCK USD.001	/etf/ea/ETZCW.djhtm?c=1&etfid=CERS.US&back=FHLC
BBIO	BRIDGEBIO PHARMA INC COMMON STOCK	/etf/ea/ETZCW.djhtm?c=1&etfid=BBIO.US&back=FHLC
SIGA	SIGA TECHNOLOGIES INC COMMON STOCK USD.0001	/etf/ea/ETZCW.djhtm?c=1&etfid=SIGA.US&back=FHLC
CHRS	COHERUS BIOSCIENCES INC COMMON STOCK USD.0001	/etf/ea/ETZCW.djhtm?c=1&etfid=CHRS.US&back=FHLC
NVTA	INVITAE CORP COMMON STOCK USD.0001	/etf/ea/ETZCW.djhtm?c=1&etfid=NVTA.US&back=FHLC
DH	DEFINITIVE HEALTHCARE CORP COMMON STOCK USD.001	/etf/ea/ETZCW.djhtm?c=1&etfid=DH.US&back=FHLC
BFLY	BUTTERFLY NETWORK INC COMMON STOCK USD.0001	/etf/ea/ETZCW.djhtm?c=1&etfid=BFLY.US&back=FHLC
MPLN	MULTIPLAN CORP COMMON STOCK	/etf/ea/ETZCW.djhtm?c=1&etfid=MPLN.US&back=FHLC
AERI	AERIE PHARMACEUTICALS INC COMMON STOCK USD.001	/etf/ea/ETZCW.djhtm?c=1&etfid=AERI.US&back=FHLC
SGMO	SANGAMO THERAPEUTICS INC COMMON STOCK USD.01	/etf/ea/ETZCW.djhtm?c=1&etfid=SGMO.US&back=FHLC
CSTL	CASTLE BIOSCIENCES INC COMMON STOCK USD.001	/etf/ea/ETZCW.djhtm?c=1&etfid=CSTL.US&back=FHLC
DCPH	DECIPHERA PHARMACEUTICALS IN COMMON STOCK USD.01	/etf/ea/ETZCW.djhtm?c=1&etfid=DCPH.US&back=FHLC
RLMD	RELMADA THERAPEUTICS INC COMMON STOCK	/etf/ea/ETZCW.djhtm?c=1&etfid=RLMD.US&back=FHLC
MRUS	MERUS NV COMMON STOCK EUR.05	/etf/ea/ETZCW.djhtm?c=1&etfid=MRUS.US&back=FHLC
RAPT	RAPT THERAPEUTICS INC COMMON STOCK	/etf/ea/ETZCW.djhtm?c=1&etfid=RAPT.US&back=FHLC
RCKT	ROCKET PHARMACEUTICALS INC COMMON STOCK USD.01	/etf/ea/ETZCW.djhtm?c=1&etfid=RCKT.US&back=FHLC
SENS	SENSEONICS HOLDINGS INC COMMON STOCK USD.001	/etf/ea/ETZCW.djhtm?c=1&etfid=SENS.US&back=FHLC
INGN	INOGEN INC COMMON STOCK USD.001	/etf/ea/ETZCW.djhtm?c=1&etfid=INGN.US&back=FHLC
RETA	REATA PHARMACEUTICALS INC A COMMON STOCK USD.001	/etf/ea/ETZCW.djhtm?c=1&etfid=RETA.US&back=FHLC
AGEN	AGENUS INC COMMON STOCK USD.01	/etf/ea/ETZCW.djhtm?c=1&etfid=AGEN.US&back=FHLC
VRDN	VIRIDIAN THERAPEUTICS INC COMMON STOCK USD.01	/etf/ea/ETZCW.djhtm?c=1&etfid=VRDN.US&back=FHLC
MRSN	MERSANA THERAPEUTICS INC COMMON STOCK USD.0001	/etf/ea/ETZCW.djhtm?c=1&etfid=MRSN.US&back=FHLC
NSTG	NANOSTRING TECHNOLOGIES INC COMMON STOCK USD.0001	/etf/ea/ETZCW.djhtm?c=1&etfid=NSTG.US&back=FHLC
COLL	COLLEGIUM PHARMACEUTICAL INC COMMON STOCK USD.001	/etf/ea/ETZCW.djhtm?c=1&etfid=COLL.US&back=FHLC
HCAT	HEALTH CATALYST INC COMMON STOCK USD.001	/etf/ea/ETZCW.djhtm?c=1&etfid=HCAT.US&back=FHLC
MORF	MORPHIC HOLDING INC COMMON STOCK USD.0001	/etf/ea/ETZCW.djhtm?c=1&etfid=MORF.US&back=FHLC
VNDA	VANDA PHARMACEUTICALS INC COMMON STOCK USD.001	/etf/ea/ETZCW.djhtm?c=1&etfid=VNDA.US&back=FHLC
ACCD	ACCOLADE INC COMMON STOCK	/etf/ea/ETZCW.djhtm?c=1&etfid=ACCD.US&back=FHLC
SANA	SANA BIOTECHNOLOGY INC COMMON STOCK USD.0001	/etf/ea/ETZCW.djhtm?c=1&etfid=SANA.US&back=FHLC
CINC	CINCOR PHARMA INC COMMON STOCK USD.00001	/etf/ea/ETZCW.djhtm?c=1&etfid=CINC.US&back=FHLC
OCGN	OCUGEN INC COMMON STOCK USD.001	/etf/ea/ETZCW.djhtm?c=1&etfid=OCGN.US&back=FHLC
ALEC	ALECTOR INC COMMON STOCK USD.0001	/etf/ea/ETZCW.djhtm?c=1&etfid=ALEC.US&back=FHLC
HSTM	HEALTHSTREAM INC COMMON STOCK	/etf/ea/ETZCW.djhtm?c=1&etfid=HSTM.US&back=FHLC
AVIR	ATEA PHARMACEUTICALS INC COMMON STOCK USD.001	/etf/ea/ETZCW.djhtm?c=1&etfid=AVIR.US&back=FHLC
ATAI	ATAI LIFE SCIENCES NV COMMON STOCK EUR.16	/etf/ea/ETZCW.djhtm?c=1&etfid=ATAI.US&back=FHLC
ATEC	ALPHATEC HOLDINGS INC COMMON STOCK USD.0001	/etf/ea/ETZCW.djhtm?c=1&etfid=ATEC.US&back=FHLC
TBPH	THERAVANCE BIOPHARMA INC COMMON STOCK USD.00001	/etf/ea/ETZCW.djhtm?c=1&etfid=TBPH.US&back=FHLC
YMAB	Y MABS THERAPEUTICS INC COMMON STOCK USD.0001	/etf/ea/ETZCW.djhtm?c=1&etfid=YMAB.US&back=FHLC
NRC	NATIONAL RESEARCH CORP COMMON STOCK USD.001	/etf/ea/ETZCW.djhtm?c=1&etfid=NRC.US&back=FHLC
INO	INOVIO PHARMACEUTICALS INC COMMON STOCK USD.001	/etf/ea/ETZCW.djhtm?c=1&etfid=INO.US&back=FHLC
NRIX	NURIX THERAPEUTICS INC COMMON STOCK	/etf/ea/ETZCW.djhtm?c=1&etfid=NRIX.US&back=FHLC
AGTI	AGILITI INC COMMON STOCK USD.0001	/etf/ea/ETZCW.djhtm?c=1&etfid=AGTI.US&back=FHLC
CSII	CARDIOVASCULAR SYSTEMS INC COMMON STOCK	/etf/ea/ETZCW.djhtm?c=1&etfid=CSII.US&back=FHLC
TSVT	2SEVENTY BIO INC COMMON STOCK USD.0001	/etf/ea/ETZCW.djhtm?c=1&etfid=TSVT.US&back=FHLC
KROS	KEROS THERAPEUTICS INC COMMON STOCK USD.0001	/etf/ea/ETZCW.djhtm?c=1&etfid=KROS.US&back=FHLC
MCRB	SERES THERAPEUTICS INC COMMON STOCK USD.001	/etf/ea/ETZCW.djhtm?c=1&etfid=MCRB.US&back=FHLC
LUNG	PULMONX CORP COMMON STOCK	/etf/ea/ETZCW.djhtm?c=1&etfid=LUNG.US&back=FHLC
RXRX	RECURSION PHARMACEUTICALS A COMMON STOCK USD.00001	/etf/ea/ETZCW.djhtm?c=1&etfid=RXRX.US&back=FHLC
SLGC	SOMALOGIC INC COMMON STOCK USD.0001	/etf/ea/ETZCW.djhtm?c=1&etfid=SLGC.US&back=FHLC
MIRM	MIRUM PHARMACEUTICALS INC COMMON STOCK	/etf/ea/ETZCW.djhtm?c=1&etfid=MIRM.US&back=FHLC
RXDX	PROMETHEUS BIOSCIENCES INC COMMON STOCK USD.0001	/etf/ea/ETZCW.djhtm?c=1&etfid=RXDX.US&back=FHLC
KZR	KEZAR LIFE SCIENCES INC COMMON STOCK USD.001	/etf/ea/ETZCW.djhtm?c=1&etfid=KZR.US&back=FHLC
ANIP	ANI PHARMACEUTICALS INC COMMON STOCK USD.0001	/etf/ea/ETZCW.djhtm?c=1&etfid=ANIP.US&back=FHLC
HRTX	HERON THERAPEUTICS INC COMMON STOCK USD.01	/etf/ea/ETZCW.djhtm?c=1&etfid=HRTX.US&back=FHLC
CRBU	CARIBOU BIOSCIENCES INC COMMON STOCK USD.0001	/etf/ea/ETZCW.djhtm?c=1&etfid=CRBU.US&back=FHLC
IBRX	IMMUNITYBIO INC COMMON STOCK USD.0001	/etf/ea/ETZCW.djhtm?c=1&etfid=IBRX.US&back=FHLC
SIBN	SI BONE INC COMMON STOCK USD.0001	/etf/ea/ETZCW.djhtm?c=1&etfid=SIBN.US&back=FHLC
FNA	PARAGON 28 INC COMMON STOCK USD.01	/etf/ea/ETZCW.djhtm?c=1&etfid=FNA.US&back=FHLC
CARA	CARA THERAPEUTICS INC COMMON STOCK USD.001	/etf/ea/ETZCW.djhtm?c=1&etfid=CARA.US&back=FHLC
REPL	REPLIMUNE GROUP INC COMMON STOCK USD.001	/etf/ea/ETZCW.djhtm?c=1&etfid=REPL.US&back=FHLC
SRDX	SURMODICS INC COMMON STOCK USD.05	/etf/ea/ETZCW.djhtm?c=1&etfid=SRDX.US&back=FHLC
VRAY	VIEWRAY INC COMMON STOCK USD.001	/etf/ea/ETZCW.djhtm?c=1&etfid=VRAY.US&back=FHLC
GDRX	GOODRX HOLDINGS INC CLASS A COMMON STOCK USD.0001	/etf/ea/ETZCW.djhtm?c=1&etfid=GDRX.US&back=FHLC
PRCT	PROCEPT BIOROBOTICS CORP COMMON STOCK USD.00001	/etf/ea/ETZCW.djhtm?c=1&etfid=PRCT.US&back=FHLC
FMTX	FORMA THERAPEUTICS HOLDINGS COMMON STOCK	/etf/ea/ETZCW.djhtm?c=1&etfid=FMTX.US&back=FHLC
ICPT	INTERCEPT PHARMACEUTICALS IN COMMON STOCK USD.001	/etf/ea/ETZCW.djhtm?c=1&etfid=ICPT.US&back=FHLC
CPSI	COMPUTER PROGRAMS + SYSTEMS COMMON STOCK USD.001	/etf/ea/ETZCW.djhtm?c=1&etfid=CPSI.US&back=FHLC
ITOS	ITEOS THERAPEUTICS INC COMMON STOCK USD.001	/etf/ea/ETZCW.djhtm?c=1&etfid=ITOS.US&back=FHLC
PNT	POINT BIOPHARMA GLOBAL INC COMMON STOCK USD.0001	/etf/ea/ETZCW.djhtm?c=1&etfid=PNT.US&back=FHLC
ANAB	ANAPTYSBIO INC COMMON STOCK USD.001	/etf/ea/ETZCW.djhtm?c=1&etfid=ANAB.US&back=FHLC
CDXS	CODEXIS INC COMMON STOCK USD.0001	/etf/ea/ETZCW.djhtm?c=1&etfid=CDXS.US&back=FHLC
PNTG	PENNANT GROUP INC/THE COMMON STOCK USD.001	/etf/ea/ETZCW.djhtm?c=1&etfid=PNTG.US&back=FHLC
OFIX	ORTHOFIX MEDICAL INC COMMON STOCK USD.1	/etf/ea/ETZCW.djhtm?c=1&etfid=OFIX.US&back=FHLC
EGRX	EAGLE PHARMACEUTICALS INC COMMON STOCK USD.001	/etf/ea/ETZCW.djhtm?c=1&etfid=EGRX.US&back=FHLC
INBX	INHIBRX INC COMMON STOCK USD.0001	/etf/ea/ETZCW.djhtm?c=1&etfid=INBX.US&back=FHLC
MXCT	MAXCYTE INC COMMON STOCK NPV	/etf/ea/ETZCW.djhtm?c=1&etfid=MXCT.US&back=FHLC
SEER	SEER INC COMMON STOCK USD.00001	/etf/ea/ETZCW.djhtm?c=1&etfid=SEER.US&back=FHLC
VXRT	VAXART INC COMMON STOCK USD.0001	/etf/ea/ETZCW.djhtm?c=1&etfid=VXRT.US&back=FHLC
NGM	NGM BIOPHARMACEUTICALS INC COMMON STOCK USD.001	/etf/ea/ETZCW.djhtm?c=1&etfid=NGM.US&back=FHLC
KOD	KODIAK SCIENCES INC COMMON STOCK USD.0001	/etf/ea/ETZCW.djhtm?c=1&etfid=KOD.US&back=FHLC
KNSA	KINIKSA PHARMACEUTICALS A COMMON STOCK USD.000273	/etf/ea/ETZCW.djhtm?c=1&etfid=KNSA.US&back=FHLC
ALVR	ALLOVIR INC COMMON STOCK	/etf/ea/ETZCW.djhtm?c=1&etfid=ALVR.US&back=FHLC
EOLS	EVOLUS INC COMMON STOCK USD.00001	/etf/ea/ETZCW.djhtm?c=1&etfid=EOLS.US&back=FHLC
NUVB	NUVATION BIO INC COMMON STOCK USD.0001	/etf/ea/ETZCW.djhtm?c=1&etfid=NUVB.US&back=FHLC
KPTI	KARYOPHARM THERAPEUTICS INC COMMON STOCK USD.0001	/etf/ea/ETZCW.djhtm?c=1&etfid=KPTI.US&back=FHLC
ARCT	ARCTURUS THERAPEUTICS HOLDIN COMMON STOCK USD.001	/etf/ea/ETZCW.djhtm?c=1&etfid=ARCT.US&back=FHLC
CCCC	C4 THERAPEUTICS INC COMMON STOCK	/etf/ea/ETZCW.djhtm?c=1&etfid=CCCC.US&back=FHLC
PTGX	PROTAGONIST THERAPEUTICS INC COMMON STOCK USD.00001	/etf/ea/ETZCW.djhtm?c=1&etfid=PTGX.US&back=FHLC
CMAX	CAREMAX INC COMMON STOCK USD.0001	/etf/ea/ETZCW.djhtm?c=1&etfid=CMAX.US&back=FHLC
QTRX	QUANTERIX CORP COMMON STOCK USD.001	/etf/ea/ETZCW.djhtm?c=1&etfid=QTRX.US&back=FHLC
SRRK	SCHOLAR ROCK HOLDING CORP COMMON STOCK USD.001	/etf/ea/ETZCW.djhtm?c=1&etfid=SRRK.US&back=FHLC
VERA	VERA THERAPEUTICS INC COMMON STOCK USD.001	/etf/ea/ETZCW.djhtm?c=1&etfid=VERA.US&back=FHLC
TMCI	TREACE MEDICAL CONCEPTS INC COMMON STOCK USD.001	/etf/ea/ETZCW.djhtm?c=1&etfid=TMCI.US&back=FHLC
ZIMV	ZIMVIE INC COMMON STOCK USD.01	/etf/ea/ETZCW.djhtm?c=1&etfid=ZIMV.US&back=FHLC
ANIK	ANIKA THERAPEUTICS INC COMMON STOCK USD.01	/etf/ea/ETZCW.djhtm?c=1&etfid=ANIK.US&back=FHLC
ATRA	ATARA BIOTHERAPEUTICS INC COMMON STOCK USD.0001	/etf/ea/ETZCW.djhtm?c=1&etfid=ATRA.US&back=FHLC
PAHC	PHIBRO ANIMAL HEALTH CORP A COMMON STOCK USD.001	/etf/ea/ETZCW.djhtm?c=1&etfid=PAHC.US&back=FHLC
TCDA	TRICIDA INC COMMON STOCK	/etf/ea/ETZCW.djhtm?c=1&etfid=TCDA.US&back=FHLC
ERAS	ERASCA INC COMMON STOCK USD.0001	/etf/ea/ETZCW.djhtm?c=1&etfid=ERAS.US&back=FHLC
CYH	COMMUNITY HEALTH SYSTEMS INC COMMON STOCK USD.01	/etf/ea/ETZCW.djhtm?c=1&etfid=CYH.US&back=FHLC
ALBO	ALBIREO PHARMA INC COMMON STOCK USD.01	/etf/ea/ETZCW.djhtm?c=1&etfid=ALBO.US&back=FHLC
OSUR	ORASURE TECHNOLOGIES INC COMMON STOCK USD.000001	/etf/ea/ETZCW.djhtm?c=1&etfid=OSUR.US&back=FHLC
PMVP	PMV PHARMACEUTICALS INC COMMON STOCK	/etf/ea/ETZCW.djhtm?c=1&etfid=PMVP.US&back=FHLC
FULC	FULCRUM THERAPEUTICS INC COMMON STOCK USD.001	/etf/ea/ETZCW.djhtm?c=1&etfid=FULC.US&back=FHLC
DYN	DYNE THERAPEUTICS INC COMMON STOCK	/etf/ea/ETZCW.djhtm?c=1&etfid=DYN.US&back=FHLC
IDYA	IDEAYA BIOSCIENCES INC COMMON STOCK	/etf/ea/ETZCW.djhtm?c=1&etfid=IDYA.US&back=FHLC
BTAI	BIOXCEL THERAPEUTICS INC COMMON STOCK USD.001	/etf/ea/ETZCW.djhtm?c=1&etfid=BTAI.US&back=FHLC
PRVB	PROVENTION BIO INC COMMON STOCK	/etf/ea/ETZCW.djhtm?c=1&etfid=PRVB.US&back=FHLC
JYNT	JOINT CORP/THE COMMON STOCK USD.001	/etf/ea/ETZCW.djhtm?c=1&etfid=JYNT.US&back=FHLC
MDXG	MIMEDX GROUP INC COMMON STOCK USD.001	/etf/ea/ETZCW.djhtm?c=1&etfid=MDXG.US&back=FHLC
AKRO	AKERO THERAPEUTICS INC COMMON STOCK USD.0001	/etf/ea/ETZCW.djhtm?c=1&etfid=AKRO.US&back=FHLC
PETQ	PETIQ INC COMMON STOCK USD.001	/etf/ea/ETZCW.djhtm?c=1&etfid=PETQ.US&back=FHLC
QSI	QUANTUM SI INC COMMON STOCK USD.0001	/etf/ea/ETZCW.djhtm?c=1&etfid=QSI.US&back=FHLC
ACET	ADICET BIO INC COMMON STOCK USD.0001	/etf/ea/ETZCW.djhtm?c=1&etfid=ACET.US&back=FHLC
PGEN	PRECIGEN INC COMMON STOCK	/etf/ea/ETZCW.djhtm?c=1&etfid=PGEN.US&back=FHLC
OPRX	OPTIMIZERX CORP COMMON STOCK USD.001	/etf/ea/ETZCW.djhtm?c=1&etfid=OPRX.US&back=FHLC
STOK	STOKE THERAPEUTICS INC COMMON STOCK	/etf/ea/ETZCW.djhtm?c=1&etfid=STOK.US&back=FHLC
RPTX	REPARE THERAPEUTICS INC COMMON STOCK	/etf/ea/ETZCW.djhtm?c=1&etfid=RPTX.US&back=FHLC
MGTX	MEIRAGTX HOLDINGS PLC COMMON STOCK USD.00001	/etf/ea/ETZCW.djhtm?c=1&etfid=MGTX.US&back=FHLC
ALXO	ALX ONCOLOGY HOLDINGS INC COMMON STOCK USD.001	/etf/ea/ETZCW.djhtm?c=1&etfid=ALXO.US&back=FHLC
RIGL	RIGEL PHARMACEUTICALS INC COMMON STOCK USD.001	/etf/ea/ETZCW.djhtm?c=1&etfid=RIGL.US&back=FHLC
FDMT	4D MOLECULAR THERAPEUTICS IN COMMON STOCK USD.0001	/etf/ea/ETZCW.djhtm?c=1&etfid=FDMT.US&back=FHLC
GBIO	GENERATION BIO CO COMMON STOCK USD.0001	/etf/ea/ETZCW.djhtm?c=1&etfid=GBIO.US&back=FHLC
BVS	BIOVENTUS INC   A COMMON STOCK USD.001	/etf/ea/ETZCW.djhtm?c=1&etfid=BVS.US&back=FHLC
IMVT	IMMUNOVANT INC COMMON STOCK USD.0001	/etf/ea/ETZCW.djhtm?c=1&etfid=IMVT.US&back=FHLC
IMGO	IMAGO BIOSCIENCES INC COMMON STOCK USD.0001	/etf/ea/ETZCW.djhtm?c=1&etfid=IMGO.US&back=FHLC
LXRX	LEXICON PHARMACEUTICALS INC COMMON STOCK USD.001	/etf/ea/ETZCW.djhtm?c=1&etfid=LXRX.US&back=FHLC
AMRX	AMNEAL PHARMACEUTICALS INC COMMON STOCK USD.01	/etf/ea/ETZCW.djhtm?c=1&etfid=AMRX.US&back=FHLC
ORGO	ORGANOGENESIS HOLDINGS INC COMMON STOCK	/etf/ea/ETZCW.djhtm?c=1&etfid=ORGO.US&back=FHLC
IGMS	IGM BIOSCIENCES INC COMMON STOCK USD.01	/etf/ea/ETZCW.djhtm?c=1&etfid=IGMS.US&back=FHLC
CMRX	CHIMERIX INC COMMON STOCK USD.001	/etf/ea/ETZCW.djhtm?c=1&etfid=CMRX.US&back=FHLC
MGNX	MACROGENICS INC COMMON STOCK USD.01	/etf/ea/ETZCW.djhtm?c=1&etfid=MGNX.US&back=FHLC
HUMA	HUMACYTE INC COMMON STOCK USD.0001	/etf/ea/ETZCW.djhtm?c=1&etfid=HUMA.US&back=FHLC
GLUE	MONTE ROSA THERAPEUTICS INC COMMON STOCK USD.0001	/etf/ea/ETZCW.djhtm?c=1&etfid=GLUE.US&back=FHLC
PHAT	PHATHOM PHARMACEUTICALS INC COMMON STOCK USD.0001	/etf/ea/ETZCW.djhtm?c=1&etfid=PHAT.US&back=FHLC
VBIV	VBI VACCINES INC COMMON STOCK	/etf/ea/ETZCW.djhtm?c=1&etfid=VBIV.US&back=FHLC
TCMD	TACTILE SYSTEMS TECHNOLOGY I COMMON STOCK USD.001	/etf/ea/ETZCW.djhtm?c=1&etfid=TCMD.US&back=FHLC
CGEM	CULLINAN ONCOLOGY INC COMMON STOCK USD.0001	/etf/ea/ETZCW.djhtm?c=1&etfid=CGEM.US&back=FHLC
DICE	DICE THERAPEUTICS INC COMMON STOCK USD.0001	/etf/ea/ETZCW.djhtm?c=1&etfid=DICE.US&back=FHLC
GRNA	GREENLIGHT BIOSCIENCES HOLDI COMMON STOCK USD.0001	/etf/ea/ETZCW.djhtm?c=1&etfid=GRNA.US&back=FHLC
PRAX	PRAXIS PRECISION MEDICINES I COMMON STOCK USD.0001	/etf/ea/ETZCW.djhtm?c=1&etfid=PRAX.US&back=FHLC
TNGX	TANGO THERAPEUTICS INC COMMON STOCK USD.0001	/etf/ea/ETZCW.djhtm?c=1&etfid=TNGX.US&back=FHLC
SMFR	SEMA4 HOLDINGS CORP COMMON STOCK USD.0001	/etf/ea/ETZCW.djhtm?c=1&etfid=SMFR.US&back=FHLC
DMTK	DERMTECH INC COMMON STOCK USD.0001	/etf/ea/ETZCW.djhtm?c=1&etfid=DMTK.US&back=FHLC
AVAH	AVEANNA HEALTHCARE HOLDINGS COMMON STOCK USD.01	/etf/ea/ETZCW.djhtm?c=1&etfid=AVAH.US&back=FHLC
CELU	CELULARITY INC COMMON STOCK USD.0001	/etf/ea/ETZCW.djhtm?c=1&etfid=CELU.US&back=FHLC
