FNI
PDD	Pinduoduo Inc. (ADR)	/etf/ea/ETZCW.djhtm?c=1&etfid=PDD.US&back=FNI
IBN	ICICI Bank Limited (ADR)	/etf/ea/ETZCW.djhtm?c=1&etfid=IBN.US&back=FNI
JD	JD.com,Inc. (ADR)	/etf/ea/ETZCW.djhtm?c=1&etfid=JD.US&back=FNI
HDB	HDFC Bank Ltd. (ADR)	/etf/ea/ETZCW.djhtm?c=1&etfid=HDB.US&back=FNI
BABA	Alibaba Group Holding Limited (ADR)	/etf/ea/ETZCW.djhtm?c=1&etfid=BABA.US&back=FNI
INFY	Infosys Limited (ADR)	/etf/ea/ETZCW.djhtm?c=1&etfid=INFY.US&back=FNI
NIO	NIO Inc. (ADR)	/etf/ea/ETZCW.djhtm?c=1&etfid=NIO.US&back=FNI
BIDU	Baidu,Inc. (ADR)	/etf/ea/ETZCW.djhtm?c=1&etfid=BIDU.US&back=FNI
TTM	Tata Motors Limited (ADR)	/etf/ea/ETZCW.djhtm?c=1&etfid=TTM.US&back=FNI
RDY	Dr. Reddy's Laboratories Limited (ADR)	/etf/ea/ETZCW.djhtm?c=1&etfid=RDY.US&back=FNI
NTES	NetEase,Inc. (ADR)	/etf/ea/ETZCW.djhtm?c=1&etfid=NTES.US&back=FNI
WIT	Wipro Limited (ADR)	/etf/ea/ETZCW.djhtm?c=1&etfid=WIT.US&back=FNI
BEKE	KE Holdings Inc.	/etf/ea/ETZCW.djhtm?c=1&etfid=BEKE.US&back=FNI
MMYT	MakeMyTrip Limited	/etf/ea/ETZCW.djhtm?c=1&etfid=MMYT.US&back=FNI
WNS	WNS (Holdings) Limited (ADR)	/etf/ea/ETZCW.djhtm?c=1&etfid=WNS.US&back=FNI
LI	Li Auto Inc. (ADR)	/etf/ea/ETZCW.djhtm?c=1&etfid=LI.US&back=FNI
RNW	Renew Energy Global Plc (Class A)	/etf/ea/ETZCW.djhtm?c=1&etfid=RNW.US&back=FNI
XPEV	XPeng Inc. (ADR)	/etf/ea/ETZCW.djhtm?c=1&etfid=XPEV.US&back=FNI
EDU	New Oriental Education & Technology Group Inc. (ADR)	/etf/ea/ETZCW.djhtm?c=1&etfid=EDU.US&back=FNI
ZLAB	Zai Lab Limited (ADR)	/etf/ea/ETZCW.djhtm?c=1&etfid=ZLAB.US&back=FNI
TAL	TAL Education Group (ADR)	/etf/ea/ETZCW.djhtm?c=1&etfid=TAL.US&back=FNI
DQ	Daqo New Energy Corporation (ADR)	/etf/ea/ETZCW.djhtm?c=1&etfid=DQ.US&back=FNI
FUTU	Futu Holdings Limited (ADR)	/etf/ea/ETZCW.djhtm?c=1&etfid=FUTU.US&back=FNI
VIPS	Vipshop Holdings Limited (ADR)	/etf/ea/ETZCW.djhtm?c=1&etfid=VIPS.US&back=FNI
TME	Tencent Music Entertainment (ADR)	/etf/ea/ETZCW.djhtm?c=1&etfid=TME.US&back=FNI
HCM	Hutchison China MediTech Ltd. (ADR)	/etf/ea/ETZCW.djhtm?c=1&etfid=HCM.US&back=FNI
HTHT	H World Group Ltd. (ADR)	/etf/ea/ETZCW.djhtm?c=1&etfid=HTHT.US&back=FNI
BZ	Kanzhun Limited	/etf/ea/ETZCW.djhtm?c=1&etfid=BZ.US&back=FNI
TCOM	Trip.com Group Ltd. (ADR)	/etf/ea/ETZCW.djhtm?c=1&etfid=TCOM.US&back=FNI
YMM	Full Truck Alliance Co.,Ltd. (ADR)	/etf/ea/ETZCW.djhtm?c=1&etfid=YMM.US&back=FNI
BILI	Bilibili Inc. (ADR)	/etf/ea/ETZCW.djhtm?c=1&etfid=BILI.US&back=FNI
YUMC	Yum China Holdings,Inc.	/etf/ea/ETZCW.djhtm?c=1&etfid=YUMC.US&back=FNI
MLCO	Melco Resorts & Entertainment Ltd. (ADR)	/etf/ea/ETZCW.djhtm?c=1&etfid=MLCO.US&back=FNI
QFIN	360 DigiTech,Inc.	/etf/ea/ETZCW.djhtm?c=1&etfid=QFIN.US&back=FNI
JKS	JinkoSolar Holding Company Ltd. (ADR)	/etf/ea/ETZCW.djhtm?c=1&etfid=JKS.US&back=FNI
ATHM	Autohome Inc. (ADR)	/etf/ea/ETZCW.djhtm?c=1&etfid=ATHM.US&back=FNI
GDS	GDS Holdings Limited (ADR)	/etf/ea/ETZCW.djhtm?c=1&etfid=GDS.US&back=FNI
ZTO	ZTO Express (Cayman) Inc. (ADR)	/etf/ea/ETZCW.djhtm?c=1&etfid=ZTO.US&back=FNI
VNET	21Vianet Group Inc. (ADR)	/etf/ea/ETZCW.djhtm?c=1&etfid=VNET.US&back=FNI
WB	Weibo Corporation (ADR)	/etf/ea/ETZCW.djhtm?c=1&etfid=WB.US&back=FNI
	China Life Insurance Co.,Limited (ADR)	
IQ	iQIYI,Inc. (ADR)	/etf/ea/ETZCW.djhtm?c=1&etfid=IQ.US&back=FNI
	PetroChina Company Limited (ADR)	
	China Petroleum & Chemical Corporation (Sinopec) (ADR)	
DADA	Dada Nexus Limited (ADR)	/etf/ea/ETZCW.djhtm?c=1&etfid=DADA.US&back=FNI
RLX	RLX Technology Inc. (ADR)	/etf/ea/ETZCW.djhtm?c=1&etfid=RLX.US&back=FNI
KC	Kingsoft Cloud Holdings - ADR	/etf/ea/ETZCW.djhtm?c=1&etfid=KC.US&back=FNI
LU	Lufax Holding Ltd (ADR)	/etf/ea/ETZCW.djhtm?c=1&etfid=LU.US&back=FNI
IMAB	I-Mab (ADR)	/etf/ea/ETZCW.djhtm?c=1&etfid=IMAB.US&back=FNI
AZRE	Azure Power Global Limited	/etf/ea/ETZCW.djhtm?c=1&etfid=AZRE.US&back=FNI
	US Dollar	
