FSTA
PG	PROCTER + GAMBLE CO/THE COMMON STOCK	/etf/ea/ETZCW.djhtm?c=1&etfid=PG.US&back=FSTA
KO	COCA COLA CO/THE COMMON STOCK USD.25	/etf/ea/ETZCW.djhtm?c=1&etfid=KO.US&back=FSTA
PEP	PEPSICO INC COMMON STOCK USD.017	/etf/ea/ETZCW.djhtm?c=1&etfid=PEP.US&back=FSTA
COST	COSTCO WHOLESALE CORP COMMON STOCK USD.005	/etf/ea/ETZCW.djhtm?c=1&etfid=COST.US&back=FSTA
WMT	WALMART INC COMMON STOCK USD.1	/etf/ea/ETZCW.djhtm?c=1&etfid=WMT.US&back=FSTA
PM	PHILIP MORRIS INTERNATIONAL COMMON STOCK	/etf/ea/ETZCW.djhtm?c=1&etfid=PM.US&back=FSTA
MDLZ	MONDELEZ INTERNATIONAL INC A COMMON STOCK	/etf/ea/ETZCW.djhtm?c=1&etfid=MDLZ.US&back=FSTA
MO	ALTRIA GROUP INC COMMON STOCK USD.333	/etf/ea/ETZCW.djhtm?c=1&etfid=MO.US&back=FSTA
CL	COLGATE PALMOLIVE CO COMMON STOCK USD1.0	/etf/ea/ETZCW.djhtm?c=1&etfid=CL.US&back=FSTA
EL	ESTEE LAUDER COMPANIES CL A COMMON STOCK USD.01	/etf/ea/ETZCW.djhtm?c=1&etfid=EL.US&back=FSTA
ADM	ARCHER DANIELS MIDLAND CO COMMON STOCK	/etf/ea/ETZCW.djhtm?c=1&etfid=ADM.US&back=FSTA
GIS	GENERAL MILLS INC COMMON STOCK USD.1	/etf/ea/ETZCW.djhtm?c=1&etfid=GIS.US&back=FSTA
KMB	KIMBERLY CLARK CORP COMMON STOCK USD1.25	/etf/ea/ETZCW.djhtm?c=1&etfid=KMB.US&back=FSTA
SYY	SYSCO CORP COMMON STOCK USD1.0	/etf/ea/ETZCW.djhtm?c=1&etfid=SYY.US&back=FSTA
STZ	CONSTELLATION BRANDS INC A COMMON STOCK USD.01	/etf/ea/ETZCW.djhtm?c=1&etfid=STZ.US&back=FSTA
MNST	MONSTER BEVERAGE CORP COMMON STOCK	/etf/ea/ETZCW.djhtm?c=1&etfid=MNST.US&back=FSTA
KR	KROGER CO COMMON STOCK USD1.0	/etf/ea/ETZCW.djhtm?c=1&etfid=KR.US&back=FSTA
HSY	HERSHEY CO/THE COMMON STOCK USD1.0	/etf/ea/ETZCW.djhtm?c=1&etfid=HSY.US&back=FSTA
KDP	KEURIG DR PEPPER INC COMMON STOCK USD.01	/etf/ea/ETZCW.djhtm?c=1&etfid=KDP.US&back=FSTA
KHC	KRAFT HEINZ CO/THE COMMON STOCK USD.01	/etf/ea/ETZCW.djhtm?c=1&etfid=KHC.US&back=FSTA
WBA	WALGREENS BOOTS ALLIANCE INC COMMON STOCK USD.01	/etf/ea/ETZCW.djhtm?c=1&etfid=WBA.US&back=FSTA
BF.B	BROWN FORMAN CORP CLASS B COMMON STOCK USD.15	/etf/ea/ETZCW.djhtm?c=1&etfid=BF.B.US&back=FSTA
TSN	TYSON FOODS INC CL A COMMON STOCK USD.1	/etf/ea/ETZCW.djhtm?c=1&etfid=TSN.US&back=FSTA
MKC	MCCORMICK + CO NON VTG SHRS COMMON STOCK	/etf/ea/ETZCW.djhtm?c=1&etfid=MKC.US&back=FSTA
CHD	CHURCH + DWIGHT CO INC COMMON STOCK USD1.0	/etf/ea/ETZCW.djhtm?c=1&etfid=CHD.US&back=FSTA
K	KELLOGG CO COMMON STOCK USD.25	/etf/ea/ETZCW.djhtm?c=1&etfid=K.US&back=FSTA
CLX	CLOROX COMPANY COMMON STOCK USD1.0	/etf/ea/ETZCW.djhtm?c=1&etfid=CLX.US&back=FSTA
CAG	CONAGRA BRANDS INC COMMON STOCK USD5.0	/etf/ea/ETZCW.djhtm?c=1&etfid=CAG.US&back=FSTA
SJM	JM SMUCKER CO/THE COMMON STOCK	/etf/ea/ETZCW.djhtm?c=1&etfid=SJM.US&back=FSTA
HRL	HORMEL FOODS CORP COMMON STOCK USD.01465	/etf/ea/ETZCW.djhtm?c=1&etfid=HRL.US&back=FSTA
BG	BUNGE LTD COMMON STOCK USD.01	/etf/ea/ETZCW.djhtm?c=1&etfid=BG.US&back=FSTA
DAR	DARLING INGREDIENTS INC COMMON STOCK USD.01	/etf/ea/ETZCW.djhtm?c=1&etfid=DAR.US&back=FSTA
LW	LAMB WESTON HOLDINGS INC COMMON STOCK USD1.0	/etf/ea/ETZCW.djhtm?c=1&etfid=LW.US&back=FSTA
BJ	BJ S WHOLESALE CLUB HOLDINGS COMMON STOCK USD.01	/etf/ea/ETZCW.djhtm?c=1&etfid=BJ.US&back=FSTA
CPB	CAMPBELL SOUP CO COMMON STOCK USD.0375	/etf/ea/ETZCW.djhtm?c=1&etfid=CPB.US&back=FSTA
TAP	MOLSON COORS BEVERAGE CO   B COMMON STOCK USD.01	/etf/ea/ETZCW.djhtm?c=1&etfid=TAP.US&back=FSTA
CASY	CASEY S GENERAL STORES INC COMMON STOCK NPV	/etf/ea/ETZCW.djhtm?c=1&etfid=CASY.US&back=FSTA
PFGC	PERFORMANCE FOOD GROUP CO COMMON STOCK USD.01	/etf/ea/ETZCW.djhtm?c=1&etfid=PFGC.US&back=FSTA
USFD	US FOODS HOLDING CORP COMMON STOCK USD.01	/etf/ea/ETZCW.djhtm?c=1&etfid=USFD.US&back=FSTA
INGR	INGREDION INC COMMON STOCK USD.01	/etf/ea/ETZCW.djhtm?c=1&etfid=INGR.US&back=FSTA
FLO	FLOWERS FOODS INC COMMON STOCK USD.01	/etf/ea/ETZCW.djhtm?c=1&etfid=FLO.US&back=FSTA
POST	POST HOLDINGS INC COMMON STOCK USD.01	/etf/ea/ETZCW.djhtm?c=1&etfid=POST.US&back=FSTA
CELH	CELSIUS HOLDINGS INC COMMON STOCK USD.001	/etf/ea/ETZCW.djhtm?c=1&etfid=CELH.US&back=FSTA
GO	GROCERY OUTLET HOLDING CORP COMMON STOCK USD.001	/etf/ea/ETZCW.djhtm?c=1&etfid=GO.US&back=FSTA
LANC	LANCASTER COLONY CORP COMMON STOCK	/etf/ea/ETZCW.djhtm?c=1&etfid=LANC.US&back=FSTA
SFM	SPROUTS FARMERS MARKET INC COMMON STOCK USD.001	/etf/ea/ETZCW.djhtm?c=1&etfid=SFM.US&back=FSTA
BRBR	BELLRING BRANDS INC COMMON STOCK USD.01	/etf/ea/ETZCW.djhtm?c=1&etfid=BRBR.US&back=FSTA
TWNK	HOSTESS BRANDS INC COMMON STOCK USD.0001	/etf/ea/ETZCW.djhtm?c=1&etfid=TWNK.US&back=FSTA
SAM	BOSTON BEER COMPANY INC A COMMON STOCK USD.01	/etf/ea/ETZCW.djhtm?c=1&etfid=SAM.US&back=FSTA
THS	TREEHOUSE FOODS INC COMMON STOCK USD.01	/etf/ea/ETZCW.djhtm?c=1&etfid=THS.US&back=FSTA
UNFI	UNITED NATURAL FOODS INC COMMON STOCK USD.01	/etf/ea/ETZCW.djhtm?c=1&etfid=UNFI.US&back=FSTA
COTY	COTY INC CL A COMMON STOCK USD.01	/etf/ea/ETZCW.djhtm?c=1&etfid=COTY.US&back=FSTA
SMPL	SIMPLY GOOD FOODS CO/THE COMMON STOCK USD.0001	/etf/ea/ETZCW.djhtm?c=1&etfid=SMPL.US&back=FSTA
	ELF BEAUTY INC COMMON STOCK USD.01	
WDFC	WD 40 CO COMMON STOCK USD.001	/etf/ea/ETZCW.djhtm?c=1&etfid=WDFC.US&back=FSTA
SPB	SPECTRUM BRANDS HOLDINGS INC COMMON STOCK USD.01	/etf/ea/ETZCW.djhtm?c=1&etfid=SPB.US&back=FSTA
JJSF	J + J SNACK FOODS CORP COMMON STOCK	/etf/ea/ETZCW.djhtm?c=1&etfid=JJSF.US&back=FSTA
HLF	HERBALIFE NUTRITION LTD COMMON STOCK USD.002	/etf/ea/ETZCW.djhtm?c=1&etfid=HLF.US&back=FSTA
CALM	CAL MAINE FOODS INC COMMON STOCK USD.01	/etf/ea/ETZCW.djhtm?c=1&etfid=CALM.US&back=FSTA
COKE	COCA COLA CONSOLIDATED INC COMMON STOCK USD1.0	/etf/ea/ETZCW.djhtm?c=1&etfid=COKE.US&back=FSTA
FRPT	FRESHPET INC COMMON STOCK USD.001	/etf/ea/ETZCW.djhtm?c=1&etfid=FRPT.US&back=FSTA
EPC	EDGEWELL PERSONAL CARE CO COMMON STOCK USD.01	/etf/ea/ETZCW.djhtm?c=1&etfid=EPC.US&back=FSTA
NUS	NU SKIN ENTERPRISES INC   A COMMON STOCK USD.001	/etf/ea/ETZCW.djhtm?c=1&etfid=NUS.US&back=FSTA
MGPI	MGP INGREDIENTS INC COMMON STOCK	/etf/ea/ETZCW.djhtm?c=1&etfid=MGPI.US&back=FSTA
REYN	REYNOLDS CONSUMER PRODUCTS I COMMON STOCK USD.001	/etf/ea/ETZCW.djhtm?c=1&etfid=REYN.US&back=FSTA
	SS INST TREAS PLUS MM FUND TRU SS INST TREAS PLUS MM FUND TR	
ENR	ENERGIZER HOLDINGS INC COMMON STOCK	/etf/ea/ETZCW.djhtm?c=1&etfid=ENR.US&back=FSTA
FIZZ	NATIONAL BEVERAGE CORP COMMON STOCK USD.01	/etf/ea/ETZCW.djhtm?c=1&etfid=FIZZ.US&back=FSTA
PSMT	PRICESMART INC COMMON STOCK USD.0001	/etf/ea/ETZCW.djhtm?c=1&etfid=PSMT.US&back=FSTA
CENT	CENTRAL GARDEN AND PET CO A COMMON STOCK USD.01	/etf/ea/ETZCW.djhtm?c=1&etfid=CENT.US&back=FSTA
HAIN	HAIN CELESTIAL GROUP INC COMMON STOCK USD.01	/etf/ea/ETZCW.djhtm?c=1&etfid=HAIN.US&back=FSTA
IPAR	INTER PARFUMS INC COMMON STOCK USD.001	/etf/ea/ETZCW.djhtm?c=1&etfid=IPAR.US&back=FSTA
BGS	B+G FOODS INC COMMON STOCK USD.01	/etf/ea/ETZCW.djhtm?c=1&etfid=BGS.US&back=FSTA
MED	MEDIFAST INC COMMON STOCK USD.001	/etf/ea/ETZCW.djhtm?c=1&etfid=MED.US&back=FSTA
WMK	WEIS MARKETS INC COMMON STOCK	/etf/ea/ETZCW.djhtm?c=1&etfid=WMK.US&back=FSTA
PPC	PILGRIM S PRIDE CORP COMMON STOCK USD.01	/etf/ea/ETZCW.djhtm?c=1&etfid=PPC.US&back=FSTA
UVV	UNIVERSAL CORP/VA COMMON STOCK	/etf/ea/ETZCW.djhtm?c=1&etfid=UVV.US&back=FSTA
IMKTA	INGLES MARKETS INC CLASS A COMMON STOCK USD.05	/etf/ea/ETZCW.djhtm?c=1&etfid=IMKTA.US&back=FSTA
VGR	VECTOR GROUP LTD COMMON STOCK USD.1	/etf/ea/ETZCW.djhtm?c=1&etfid=VGR.US&back=FSTA
ANDE	ANDERSONS INC/THE COMMON STOCK	/etf/ea/ETZCW.djhtm?c=1&etfid=ANDE.US&back=FSTA
CHEF	CHEFS  WAREHOUSE INC/THE COMMON STOCK USD.01	/etf/ea/ETZCW.djhtm?c=1&etfid=CHEF.US&back=FSTA
UTZ	UTZ BRANDS INC COMMON STOCK USD.0001	/etf/ea/ETZCW.djhtm?c=1&etfid=UTZ.US&back=FSTA
SEB	SEABOARD CORP COMMON STOCK USD1.0	/etf/ea/ETZCW.djhtm?c=1&etfid=SEB.US&back=FSTA
BYND	BEYOND MEAT INC COMMON STOCK	/etf/ea/ETZCW.djhtm?c=1&etfid=BYND.US&back=FSTA
VERU	VERU INC COMMON STOCK USD.01	/etf/ea/ETZCW.djhtm?c=1&etfid=VERU.US&back=FSTA
SKIN	BEAUTY HEALTH CO/THE COMMON STOCK USD.0001	/etf/ea/ETZCW.djhtm?c=1&etfid=SKIN.US&back=FSTA
SPTN	SPARTANNASH CO COMMON STOCK	/etf/ea/ETZCW.djhtm?c=1&etfid=SPTN.US&back=FSTA
FDP	FRESH DEL MONTE PRODUCE INC COMMON STOCK USD.01	/etf/ea/ETZCW.djhtm?c=1&etfid=FDP.US&back=FSTA
JBSS	JOHN B. SANFILIPPO + SON INC COMMON STOCK USD.01	/etf/ea/ETZCW.djhtm?c=1&etfid=JBSS.US&back=FSTA
CVGW	CALAVO GROWERS INC COMMON STOCK USD.001	/etf/ea/ETZCW.djhtm?c=1&etfid=CVGW.US&back=FSTA
NAPA	DUCKHORN PORTFOLIO INC/THE COMMON STOCK USD.01	/etf/ea/ETZCW.djhtm?c=1&etfid=NAPA.US&back=FSTA
AVO	MISSION PRODUCE INC COMMON STOCK USD.001	/etf/ea/ETZCW.djhtm?c=1&etfid=AVO.US&back=FSTA
USNA	USANA HEALTH SCIENCES INC COMMON STOCK USD.001	/etf/ea/ETZCW.djhtm?c=1&etfid=USNA.US&back=FSTA
TR	TOOTSIE ROLL INDS COMMON STOCK USD.694	/etf/ea/ETZCW.djhtm?c=1&etfid=TR.US&back=FSTA
SOVO	SOVOS BRANDS INC COMMON STOCK USD.001	/etf/ea/ETZCW.djhtm?c=1&etfid=SOVO.US&back=FSTA
CENT	CENTRAL GARDEN + PET CO COMMON STOCK USD.01	/etf/ea/ETZCW.djhtm?c=1&etfid=CENT.US&back=FSTA
BHIL	BENSON HILL INC COMMON STOCK USD.0001	/etf/ea/ETZCW.djhtm?c=1&etfid=BHIL.US&back=FSTA
RAD	RITE AID CORP COMMON STOCK USD1.0	/etf/ea/ETZCW.djhtm?c=1&etfid=RAD.US&back=FSTA
TPB	TURNING POINT BRANDS INC COMMON STOCK USD.01	/etf/ea/ETZCW.djhtm?c=1&etfid=TPB.US&back=FSTA
TTCF	TATTOOED CHEF INC COMMON STOCK USD.0001	/etf/ea/ETZCW.djhtm?c=1&etfid=TTCF.US&back=FSTA
VITL	VITAL FARMS INC COMMON STOCK USD.0001	/etf/ea/ETZCW.djhtm?c=1&etfid=VITL.US&back=FSTA
BRCC	BRC INC A COMMON STOCK USD.0001	/etf/ea/ETZCW.djhtm?c=1&etfid=BRCC.US&back=FSTA
	US DOLLAR	
APPH	APPHARVEST INC COMMON STOCK USD.0001	/etf/ea/ETZCW.djhtm?c=1&etfid=APPH.US&back=FSTA
HNST	HONEST CO INC/THE COMMON STOCK USD.001	/etf/ea/ETZCW.djhtm?c=1&etfid=HNST.US&back=FSTA
VWE	VINTAGE WINE ESTATES INC COMMON STOCK	/etf/ea/ETZCW.djhtm?c=1&etfid=VWE.US&back=FSTA
LOCL	LOCAL BOUNTI CORP COMMON STOCK USD.0001	/etf/ea/ETZCW.djhtm?c=1&etfid=LOCL.US&back=FSTA
