FTCS
TT	Trane Technologies Plc	/etf/ea/ETZCW.djhtm?c=1&etfid=TT.US&back=FTCS
ADP	Automatic Data Processing,Inc.	/etf/ea/ETZCW.djhtm?c=1&etfid=ADP.US&back=FTCS
NDAQ	Nasdaq,Inc.	/etf/ea/ETZCW.djhtm?c=1&etfid=NDAQ.US&back=FTCS
APD	Air Products and Chemicals,Inc.	/etf/ea/ETZCW.djhtm?c=1&etfid=APD.US&back=FTCS
APH	Amphenol Corporation	/etf/ea/ETZCW.djhtm?c=1&etfid=APH.US&back=FTCS
CSX	CSX Corporation	/etf/ea/ETZCW.djhtm?c=1&etfid=CSX.US&back=FTCS
HON	Honeywell International Inc.	/etf/ea/ETZCW.djhtm?c=1&etfid=HON.US&back=FTCS
CMI	Cummins Inc.	/etf/ea/ETZCW.djhtm?c=1&etfid=CMI.US&back=FTCS
GD	General Dynamics Corporation	/etf/ea/ETZCW.djhtm?c=1&etfid=GD.US&back=FTCS
ITW	Illinois Tool Works Inc.	/etf/ea/ETZCW.djhtm?c=1&etfid=ITW.US&back=FTCS
PAYX	Paychex,Inc.	/etf/ea/ETZCW.djhtm?c=1&etfid=PAYX.US&back=FTCS
NSC	Norfolk Southern Corporation	/etf/ea/ETZCW.djhtm?c=1&etfid=NSC.US&back=FTCS
PH	Parker-Hannifin Corporation	/etf/ea/ETZCW.djhtm?c=1&etfid=PH.US&back=FTCS
UPS	United Parcel Service,Inc. (Class B)	/etf/ea/ETZCW.djhtm?c=1&etfid=UPS.US&back=FTCS
ICE	Intercontinental Exchange,Inc.	/etf/ea/ETZCW.djhtm?c=1&etfid=ICE.US&back=FTCS
DHR	Danaher Corporation	/etf/ea/ETZCW.djhtm?c=1&etfid=DHR.US&back=FTCS
LMT	Lockheed Martin Corporation	/etf/ea/ETZCW.djhtm?c=1&etfid=LMT.US&back=FTCS
NOC	Northrop Grumman Corporation	/etf/ea/ETZCW.djhtm?c=1&etfid=NOC.US&back=FTCS
CSCO	Cisco Systems,Inc.	/etf/ea/ETZCW.djhtm?c=1&etfid=CSCO.US&back=FTCS
ABC	AmerisourceBergen Corporation	/etf/ea/ETZCW.djhtm?c=1&etfid=ABC.US&back=FTCS
TXN	Texas Instruments Incorporated	/etf/ea/ETZCW.djhtm?c=1&etfid=TXN.US&back=FTCS
EMR	Emerson Electric Co.	/etf/ea/ETZCW.djhtm?c=1&etfid=EMR.US&back=FTCS
AON	AON Plc	/etf/ea/ETZCW.djhtm?c=1&etfid=AON.US&back=FTCS
WMT	Walmart,Inc.	/etf/ea/ETZCW.djhtm?c=1&etfid=WMT.US&back=FTCS
WRB	W.R. Berkley Corporation	/etf/ea/ETZCW.djhtm?c=1&etfid=WRB.US&back=FTCS
MDLZ	Mondelez International,Inc.	/etf/ea/ETZCW.djhtm?c=1&etfid=MDLZ.US&back=FTCS
MCO	Moody's Corporation	/etf/ea/ETZCW.djhtm?c=1&etfid=MCO.US&back=FTCS
SPGI	S&P Global Inc.	/etf/ea/ETZCW.djhtm?c=1&etfid=SPGI.US&back=FTCS
PEP	PepsiCo,Inc.	/etf/ea/ETZCW.djhtm?c=1&etfid=PEP.US&back=FTCS
ELV	Elevance Health Inc.	/etf/ea/ETZCW.djhtm?c=1&etfid=ELV.US&back=FTCS
HUM	Humana Inc.	/etf/ea/ETZCW.djhtm?c=1&etfid=HUM.US&back=FTCS
KO	The Coca-Cola Company	/etf/ea/ETZCW.djhtm?c=1&etfid=KO.US&back=FTCS
UNH	UnitedHealth Group Incorporated	/etf/ea/ETZCW.djhtm?c=1&etfid=UNH.US&back=FTCS
WY	Weyerhaeuser Company	/etf/ea/ETZCW.djhtm?c=1&etfid=WY.US&back=FTCS
AMGN	Amgen Inc.	/etf/ea/ETZCW.djhtm?c=1&etfid=AMGN.US&back=FTCS
MMM	3M Company	/etf/ea/ETZCW.djhtm?c=1&etfid=MMM.US&back=FTCS
REGN	Regeneron Pharmaceuticals,Inc.	/etf/ea/ETZCW.djhtm?c=1&etfid=REGN.US&back=FTCS
PG	The Procter & Gamble Company	/etf/ea/ETZCW.djhtm?c=1&etfid=PG.US&back=FTCS
HOLX	Hologic,Inc.	/etf/ea/ETZCW.djhtm?c=1&etfid=HOLX.US&back=FTCS
ABT	Abbott Laboratories	/etf/ea/ETZCW.djhtm?c=1&etfid=ABT.US&back=FTCS
LH	Laboratory Corporation of America Holdings	/etf/ea/ETZCW.djhtm?c=1&etfid=LH.US&back=FTCS
MNST	Monster Beverage Corporation	/etf/ea/ETZCW.djhtm?c=1&etfid=MNST.US&back=FTCS
LLY	Eli Lilly and Company	/etf/ea/ETZCW.djhtm?c=1&etfid=LLY.US&back=FTCS
JNJ	Johnson & Johnson	/etf/ea/ETZCW.djhtm?c=1&etfid=JNJ.US&back=FTCS
MRK	Merck & Co.,Inc.	/etf/ea/ETZCW.djhtm?c=1&etfid=MRK.US&back=FTCS
ZTS	Zoetis Inc.	/etf/ea/ETZCW.djhtm?c=1&etfid=ZTS.US&back=FTCS
BMY	Bristol-Myers Squibb Company	/etf/ea/ETZCW.djhtm?c=1&etfid=BMY.US&back=FTCS
GRMN	Garmin Ltd.	/etf/ea/ETZCW.djhtm?c=1&etfid=GRMN.US&back=FTCS
ABBV	AbbVie Inc.	/etf/ea/ETZCW.djhtm?c=1&etfid=ABBV.US&back=FTCS
CINF	Cincinnati Financial Corporation	/etf/ea/ETZCW.djhtm?c=1&etfid=CINF.US&back=FTCS
	US Dollar	
