IHE
JNJ	JOHNSON & JOHNSON	/etf/ea/ETZCW.djhtm?c=1&etfid=JNJ.US&back=IHE
PFE	PFIZER INC	/etf/ea/ETZCW.djhtm?c=1&etfid=PFE.US&back=IHE
RPRX	ROYALTY PHARMA PLC CLASS A	/etf/ea/ETZCW.djhtm?c=1&etfid=RPRX.US&back=IHE
LLY	ELI LILLY	/etf/ea/ETZCW.djhtm?c=1&etfid=LLY.US&back=IHE
MRK	MERCK & CO INC	/etf/ea/ETZCW.djhtm?c=1&etfid=MRK.US&back=IHE
ZTS	ZOETIS INC CLASS A	/etf/ea/ETZCW.djhtm?c=1&etfid=ZTS.US&back=IHE
BMY	BRISTOL MYERS SQUIBB	/etf/ea/ETZCW.djhtm?c=1&etfid=BMY.US&back=IHE
VTRS	VIATRIS INC	/etf/ea/ETZCW.djhtm?c=1&etfid=VTRS.US&back=IHE
CTLT	CATALENTINC	/etf/ea/ETZCW.djhtm?c=1&etfid=CTLT.US&back=IHE
JAZZ	JAZZ PHARMACEUTICALS PLC	/etf/ea/ETZCW.djhtm?c=1&etfid=JAZZ.US&back=IHE
OGN	ORGANON	/etf/ea/ETZCW.djhtm?c=1&etfid=OGN.US&back=IHE
ELAN	ELANCO ANIMAL HEALTH INC	/etf/ea/ETZCW.djhtm?c=1&etfid=ELAN.US&back=IHE
PRGO	PERRIGO PLC	/etf/ea/ETZCW.djhtm?c=1&etfid=PRGO.US&back=IHE
ITCI	INTRA CELLULAR THERAPIES INC	/etf/ea/ETZCW.djhtm?c=1&etfid=ITCI.US&back=IHE
FOLD	AMICUS THERAPEUTICS INC	/etf/ea/ETZCW.djhtm?c=1&etfid=FOLD.US&back=IHE
PBH	PRESTIGE CONSUMER HEALTHCARE INC	/etf/ea/ETZCW.djhtm?c=1&etfid=PBH.US&back=IHE
CCXI	CHEMOCENTRYX INC	/etf/ea/ETZCW.djhtm?c=1&etfid=CCXI.US&back=IHE
CORT	CORCEPT THERAPEUTICS INC	/etf/ea/ETZCW.djhtm?c=1&etfid=CORT.US&back=IHE
PCRX	PACIRA BIOSCIENCES INC	/etf/ea/ETZCW.djhtm?c=1&etfid=PCRX.US&back=IHE
AXSM	AXSOME THERAPEUTICS INC	/etf/ea/ETZCW.djhtm?c=1&etfid=AXSM.US&back=IHE
ARVN	ARVINAS INC	/etf/ea/ETZCW.djhtm?c=1&etfid=ARVN.US&back=IHE
IRWD	IRONWOOD PHARMA INC CLASS A	/etf/ea/ETZCW.djhtm?c=1&etfid=IRWD.US&back=IHE
RVNC	REVANCE THERAPEUTICS INC	/etf/ea/ETZCW.djhtm?c=1&etfid=RVNC.US&back=IHE
CPRX	CATALYST PHARMACEUTICALS INC	/etf/ea/ETZCW.djhtm?c=1&etfid=CPRX.US&back=IHE
	USD CASH	
AMPH	AMPHASTAR PHARMACEUTICALS INC	/etf/ea/ETZCW.djhtm?c=1&etfid=AMPH.US&back=IHE
HRMY	HARMONY BIOSCIENCES HLDG INC	/etf/ea/ETZCW.djhtm?c=1&etfid=HRMY.US&back=IHE
SAVA	CASSAVA SCIENCES INC	/etf/ea/ETZCW.djhtm?c=1&etfid=SAVA.US&back=IHE
MDGL	MADRIGAL PHARMACEUTICALS INC	/etf/ea/ETZCW.djhtm?c=1&etfid=MDGL.US&back=IHE
INVA	INNOVIVA INC	/etf/ea/ETZCW.djhtm?c=1&etfid=INVA.US&back=IHE
AERI	AERIE PHARMACEUTICALS INC	/etf/ea/ETZCW.djhtm?c=1&etfid=AERI.US&back=IHE
RETA	REATA PHARMACEUTICALS INC CLASS A	/etf/ea/ETZCW.djhtm?c=1&etfid=RETA.US&back=IHE
VNDA	VANDA PHARMACEUTICALS INC	/etf/ea/ETZCW.djhtm?c=1&etfid=VNDA.US&back=IHE
COLL	COLLEGIUM PHARMACEUTICAL INC	/etf/ea/ETZCW.djhtm?c=1&etfid=COLL.US&back=IHE
NGM	NGM BIOPHARMACEUTICALS INC	/etf/ea/ETZCW.djhtm?c=1&etfid=NGM.US&back=IHE
TBPH	THERAVANCE BIOPHARMA INC	/etf/ea/ETZCW.djhtm?c=1&etfid=TBPH.US&back=IHE
CARA	CARA THERAPEUTICS INC	/etf/ea/ETZCW.djhtm?c=1&etfid=CARA.US&back=IHE
AVIR	ATEA PHARMACEUTICALS INC	/etf/ea/ETZCW.djhtm?c=1&etfid=AVIR.US&back=IHE
ROIV	ROIVANT SCIENCES LTD	/etf/ea/ETZCW.djhtm?c=1&etfid=ROIV.US&back=IHE
NUVB	NUVATION BIO INC CLASS A	/etf/ea/ETZCW.djhtm?c=1&etfid=NUVB.US&back=IHE
PAHC	PHIBRO ANIMAL HEALTH CORP CLASS A	/etf/ea/ETZCW.djhtm?c=1&etfid=PAHC.US&back=IHE
AMRX	AMNEAL PHARMACEUTICALS INC CLASS A	/etf/ea/ETZCW.djhtm?c=1&etfid=AMRX.US&back=IHE
	CASH COLLATERAL USD SGAFT	
	BLK CSH FND TREASURY SL AGENCY	
	E-MINI HEALTH CARE SECTOR SEP 22	
