IVW
AAPL	APPLE INC	/etf/ea/ETZCW.djhtm?c=1&etfid=AAPL.US&back=IVW
MSFT	MICROSOFT CORP	/etf/ea/ETZCW.djhtm?c=1&etfid=MSFT.US&back=IVW
AMZN	AMAZON COM INC	/etf/ea/ETZCW.djhtm?c=1&etfid=AMZN.US&back=IVW
TSLA	TESLA INC	/etf/ea/ETZCW.djhtm?c=1&etfid=TSLA.US&back=IVW
GOOGL	ALPHABET INC CLASS A	/etf/ea/ETZCW.djhtm?c=1&etfid=GOOGL.US&back=IVW
GOOG	ALPHABET INC CLASS C	/etf/ea/ETZCW.djhtm?c=1&etfid=GOOG.US&back=IVW
NVDA	NVIDIA CORP	/etf/ea/ETZCW.djhtm?c=1&etfid=NVDA.US&back=IVW
META	META PLATFORMS INC CLASS A	/etf/ea/ETZCW.djhtm?c=1&etfid=META.US&back=IVW
LLY	ELI LILLY	/etf/ea/ETZCW.djhtm?c=1&etfid=LLY.US&back=IVW
HD	HOME DEPOT INC	/etf/ea/ETZCW.djhtm?c=1&etfid=HD.US&back=IVW
TMO	THERMO FISHER SCIENTIFIC INC	/etf/ea/ETZCW.djhtm?c=1&etfid=TMO.US&back=IVW
UNH	UNITEDHEALTH GROUP INC	/etf/ea/ETZCW.djhtm?c=1&etfid=UNH.US&back=IVW
ADBE	ADOBE INC	/etf/ea/ETZCW.djhtm?c=1&etfid=ADBE.US&back=IVW
JPM	JPMORGAN CHASE & CO	/etf/ea/ETZCW.djhtm?c=1&etfid=JPM.US&back=IVW
QCOM	QUALCOMM INC	/etf/ea/ETZCW.djhtm?c=1&etfid=QCOM.US&back=IVW
V	VISA INC CLASS A	/etf/ea/ETZCW.djhtm?c=1&etfid=V.US&back=IVW
AMD	ADVANCED MICRO DEVICES INC	/etf/ea/ETZCW.djhtm?c=1&etfid=AMD.US&back=IVW
PFE	PFIZER INC	/etf/ea/ETZCW.djhtm?c=1&etfid=PFE.US&back=IVW
MA	MASTERCARD INC CLASS A	/etf/ea/ETZCW.djhtm?c=1&etfid=MA.US&back=IVW
LOW	LOWES COMPANIES INC	/etf/ea/ETZCW.djhtm?c=1&etfid=LOW.US&back=IVW
ABBV	ABBVIE INC	/etf/ea/ETZCW.djhtm?c=1&etfid=ABBV.US&back=IVW
INTU	INTUIT INC	/etf/ea/ETZCW.djhtm?c=1&etfid=INTU.US&back=IVW
DHR	DANAHER CORP	/etf/ea/ETZCW.djhtm?c=1&etfid=DHR.US&back=IVW
COST	COSTCO WHOLESALE CORP	/etf/ea/ETZCW.djhtm?c=1&etfid=COST.US&back=IVW
ORCL	ORACLE CORP	/etf/ea/ETZCW.djhtm?c=1&etfid=ORCL.US&back=IVW
AVGO	BROADCOM INC	/etf/ea/ETZCW.djhtm?c=1&etfid=AVGO.US&back=IVW
GS	GOLDMAN SACHS GROUP INC	/etf/ea/ETZCW.djhtm?c=1&etfid=GS.US&back=IVW
ACN	ACCENTURE PLC CLASS A	/etf/ea/ETZCW.djhtm?c=1&etfid=ACN.US&back=IVW
BAC	BANK OF AMERICA CORP	/etf/ea/ETZCW.djhtm?c=1&etfid=BAC.US&back=IVW
PEP	PEPSICO INC	/etf/ea/ETZCW.djhtm?c=1&etfid=PEP.US&back=IVW
NFLX	NETFLIX INC	/etf/ea/ETZCW.djhtm?c=1&etfid=NFLX.US&back=IVW
ABT	ABBOTT LABORATORIES	/etf/ea/ETZCW.djhtm?c=1&etfid=ABT.US&back=IVW
CRM	SALESFORCE INC	/etf/ea/ETZCW.djhtm?c=1&etfid=CRM.US&back=IVW
NOW	SERVICENOW INC	/etf/ea/ETZCW.djhtm?c=1&etfid=NOW.US&back=IVW
MCD	MCDONALDS CORP	/etf/ea/ETZCW.djhtm?c=1&etfid=MCD.US&back=IVW
CSCO	CISCO SYSTEMS INC	/etf/ea/ETZCW.djhtm?c=1&etfid=CSCO.US&back=IVW
AMAT	APPLIED MATERIAL INC	/etf/ea/ETZCW.djhtm?c=1&etfid=AMAT.US&back=IVW
TXN	TEXAS INSTRUMENT INC	/etf/ea/ETZCW.djhtm?c=1&etfid=TXN.US&back=IVW
SPGI	S&P GLOBAL INC	/etf/ea/ETZCW.djhtm?c=1&etfid=SPGI.US&back=IVW
NKE	NIKE INC CLASS B	/etf/ea/ETZCW.djhtm?c=1&etfid=NKE.US&back=IVW
SCHW	CHARLES SCHWAB CORP	/etf/ea/ETZCW.djhtm?c=1&etfid=SCHW.US&back=IVW
LIN	LINDE PLC	/etf/ea/ETZCW.djhtm?c=1&etfid=LIN.US&back=IVW
REGN	REGENERON PHARMACEUTICALS INC	/etf/ea/ETZCW.djhtm?c=1&etfid=REGN.US&back=IVW
UPS	UNITED PARCEL SERVICE INC CLASS B	/etf/ea/ETZCW.djhtm?c=1&etfid=UPS.US&back=IVW
LRCX	LAM RESEARCH CORP	/etf/ea/ETZCW.djhtm?c=1&etfid=LRCX.US&back=IVW
AMT	AMERICAN TOWER REIT CORP	/etf/ea/ETZCW.djhtm?c=1&etfid=AMT.US&back=IVW
PYPL	PAYPAL HOLDINGS INC	/etf/ea/ETZCW.djhtm?c=1&etfid=PYPL.US&back=IVW
MS	MORGAN STANLEY	/etf/ea/ETZCW.djhtm?c=1&etfid=MS.US&back=IVW
UNP	UNION PACIFIC CORP	/etf/ea/ETZCW.djhtm?c=1&etfid=UNP.US&back=IVW
PLD	PROLOGIS REIT INC	/etf/ea/ETZCW.djhtm?c=1&etfid=PLD.US&back=IVW
ADP	AUTOMATIC DATA PROCESSING INC	/etf/ea/ETZCW.djhtm?c=1&etfid=ADP.US&back=IVW
AMGN	AMGEN INC	/etf/ea/ETZCW.djhtm?c=1&etfid=AMGN.US&back=IVW
KLAC	KLA CORP	/etf/ea/ETZCW.djhtm?c=1&etfid=KLAC.US&back=IVW
ISRG	INTUITIVE SURGICAL INC	/etf/ea/ETZCW.djhtm?c=1&etfid=ISRG.US&back=IVW
MMC	MARSH & MCLENNAN INC	/etf/ea/ETZCW.djhtm?c=1&etfid=MMC.US&back=IVW
BLK	BLACKROCK INC	/etf/ea/ETZCW.djhtm?c=1&etfid=BLK.US&back=IVW
SBUX	STARBUCKS CORP	/etf/ea/ETZCW.djhtm?c=1&etfid=SBUX.US&back=IVW
ZTS	ZOETIS INC CLASS A	/etf/ea/ETZCW.djhtm?c=1&etfid=ZTS.US&back=IVW
CDNS	CADENCE DESIGN SYSTEMS INC	/etf/ea/ETZCW.djhtm?c=1&etfid=CDNS.US&back=IVW
DE	DEERE	/etf/ea/ETZCW.djhtm?c=1&etfid=DE.US&back=IVW
ORLY	OREILLY AUTOMOTIVE INC	/etf/ea/ETZCW.djhtm?c=1&etfid=ORLY.US&back=IVW
MRNA	MODERNA INC	/etf/ea/ETZCW.djhtm?c=1&etfid=MRNA.US&back=IVW
DVN	DEVON ENERGY CORP	/etf/ea/ETZCW.djhtm?c=1&etfid=DVN.US&back=IVW
VRTX	VERTEX PHARMACEUTICALS INC	/etf/ea/ETZCW.djhtm?c=1&etfid=VRTX.US&back=IVW
AZO	AUTOZONE INC	/etf/ea/ETZCW.djhtm?c=1&etfid=AZO.US&back=IVW
AXP	AMERICAN EXPRESS	/etf/ea/ETZCW.djhtm?c=1&etfid=AXP.US&back=IVW
TGT	TARGET CORP	/etf/ea/ETZCW.djhtm?c=1&etfid=TGT.US&back=IVW
ENPH	ENPHASE ENERGY INC	/etf/ea/ETZCW.djhtm?c=1&etfid=ENPH.US&back=IVW
MSCI	MSCI INC	/etf/ea/ETZCW.djhtm?c=1&etfid=MSCI.US&back=IVW
AON	AON PLC CLASS A	/etf/ea/ETZCW.djhtm?c=1&etfid=AON.US&back=IVW
SNPS	SYNOPSYS INC	/etf/ea/ETZCW.djhtm?c=1&etfid=SNPS.US&back=IVW
EW	EDWARDS LIFESCIENCES CORP	/etf/ea/ETZCW.djhtm?c=1&etfid=EW.US&back=IVW
EL	ESTEE LAUDER INC CLASS A	/etf/ea/ETZCW.djhtm?c=1&etfid=EL.US&back=IVW
CCI	CROWN CASTLE INC	/etf/ea/ETZCW.djhtm?c=1&etfid=CCI.US&back=IVW
WM	WASTE MANAGEMENT INC	/etf/ea/ETZCW.djhtm?c=1&etfid=WM.US&back=IVW
EOG	EOG RESOURCES INC	/etf/ea/ETZCW.djhtm?c=1&etfid=EOG.US&back=IVW
FTNT	FORTINET INC	/etf/ea/ETZCW.djhtm?c=1&etfid=FTNT.US&back=IVW
DXCM	DEXCOM INC	/etf/ea/ETZCW.djhtm?c=1&etfid=DXCM.US&back=IVW
ICE	INTERCONTINENTAL EXCHANGE INC	/etf/ea/ETZCW.djhtm?c=1&etfid=ICE.US&back=IVW
PXD	PIONEER NATURAL RESOURCE	/etf/ea/ETZCW.djhtm?c=1&etfid=PXD.US&back=IVW
MCO	MOODYS CORP	/etf/ea/ETZCW.djhtm?c=1&etfid=MCO.US&back=IVW
CMG	CHIPOTLE MEXICAN GRILL INC	/etf/ea/ETZCW.djhtm?c=1&etfid=CMG.US&back=IVW
PSA	PUBLIC STORAGE REIT	/etf/ea/ETZCW.djhtm?c=1&etfid=PSA.US&back=IVW
SHW	SHERWIN WILLIAMS	/etf/ea/ETZCW.djhtm?c=1&etfid=SHW.US&back=IVW
IQV	IQVIA HOLDINGS INC	/etf/ea/ETZCW.djhtm?c=1&etfid=IQV.US&back=IVW
SYK	STRYKER CORP	/etf/ea/ETZCW.djhtm?c=1&etfid=SYK.US&back=IVW
DFS	DISCOVER FINANCIAL SERVICES	/etf/ea/ETZCW.djhtm?c=1&etfid=DFS.US&back=IVW
ADSK	AUTODESK INC	/etf/ea/ETZCW.djhtm?c=1&etfid=ADSK.US&back=IVW
EQIX	EQUINIX REIT INC	/etf/ea/ETZCW.djhtm?c=1&etfid=EQIX.US&back=IVW
FRC	FIRST REPUBLIC BANK	/etf/ea/ETZCW.djhtm?c=1&etfid=FRC.US&back=IVW
NXPI	NXP SEMICONDUCTORS NV	/etf/ea/ETZCW.djhtm?c=1&etfid=NXPI.US&back=IVW
ANET	ARISTA NETWORKS INC	/etf/ea/ETZCW.djhtm?c=1&etfid=ANET.US&back=IVW
EXR	EXTRA SPACE STORAGE REIT INC	/etf/ea/ETZCW.djhtm?c=1&etfid=EXR.US&back=IVW
HCA	HCA HEALTHCARE INC	/etf/ea/ETZCW.djhtm?c=1&etfid=HCA.US&back=IVW
OXY	OCCIDENTAL PETROLEUM CORP	/etf/ea/ETZCW.djhtm?c=1&etfid=OXY.US&back=IVW
ODFL	OLD DOMINION FREIGHT LINE INC	/etf/ea/ETZCW.djhtm?c=1&etfid=ODFL.US&back=IVW
EPAM	EPAM SYSTEMS INC	/etf/ea/ETZCW.djhtm?c=1&etfid=EPAM.US&back=IVW
MSI	MOTOROLA SOLUTIONS INC	/etf/ea/ETZCW.djhtm?c=1&etfid=MSI.US&back=IVW
SIVB	SVB FINANCIAL GROUP	/etf/ea/ETZCW.djhtm?c=1&etfid=SIVB.US&back=IVW
HES	HESS CORP	/etf/ea/ETZCW.djhtm?c=1&etfid=HES.US&back=IVW
A	AGILENT TECHNOLOGIES INC	/etf/ea/ETZCW.djhtm?c=1&etfid=A.US&back=IVW
APH	AMPHENOL CORP CLASS A	/etf/ea/ETZCW.djhtm?c=1&etfid=APH.US&back=IVW
EFX	EQUIFAX INC	/etf/ea/ETZCW.djhtm?c=1&etfid=EFX.US&back=IVW
IT	GARTNER INC	/etf/ea/ETZCW.djhtm?c=1&etfid=IT.US&back=IVW
JCI	JOHNSON CONTROLS INTERNATIONAL PLC	/etf/ea/ETZCW.djhtm?c=1&etfid=JCI.US&back=IVW
FANG	DIAMONDBACK ENERGY INC	/etf/ea/ETZCW.djhtm?c=1&etfid=FANG.US&back=IVW
ITW	ILLINOIS TOOL INC	/etf/ea/ETZCW.djhtm?c=1&etfid=ITW.US&back=IVW
ON	ON SEMICONDUCTOR CORP	/etf/ea/ETZCW.djhtm?c=1&etfid=ON.US&back=IVW
KEYS	KEYSIGHT TECHNOLOGIES INC	/etf/ea/ETZCW.djhtm?c=1&etfid=KEYS.US&back=IVW
WST	WEST PHARMACEUTICAL SERVICES INC	/etf/ea/ETZCW.djhtm?c=1&etfid=WST.US&back=IVW
ALB	ALBEMARLE CORP	/etf/ea/ETZCW.djhtm?c=1&etfid=ALB.US&back=IVW
PAYX	PAYCHEX INC	/etf/ea/ETZCW.djhtm?c=1&etfid=PAYX.US&back=IVW
TSCO	TRACTOR SUPPLY	/etf/ea/ETZCW.djhtm?c=1&etfid=TSCO.US&back=IVW
IDXX	IDEXX LABORATORIES INC	/etf/ea/ETZCW.djhtm?c=1&etfid=IDXX.US&back=IVW
SPG	SIMON PROPERTY GROUP REIT INC	/etf/ea/ETZCW.djhtm?c=1&etfid=SPG.US&back=IVW
COF	CAPITAL ONE FINANCIAL CORP	/etf/ea/ETZCW.djhtm?c=1&etfid=COF.US&back=IVW
MPWR	MONOLITHIC POWER SYSTEMS INC	/etf/ea/ETZCW.djhtm?c=1&etfid=MPWR.US&back=IVW
	BLK CSH FND TREASURY SL AGENCY	
SBAC	SBA COMMUNICATIONS REIT CORP CLASS	/etf/ea/ETZCW.djhtm?c=1&etfid=SBAC.US&back=IVW
NUE	NUCOR CORP	/etf/ea/ETZCW.djhtm?c=1&etfid=NUE.US&back=IVW
TROW	T ROWE PRICE GROUP INC	/etf/ea/ETZCW.djhtm?c=1&etfid=TROW.US&back=IVW
EBAY	EBAY INC	/etf/ea/ETZCW.djhtm?c=1&etfid=EBAY.US&back=IVW
FCX	FREEPORT MCMORAN INC	/etf/ea/ETZCW.djhtm?c=1&etfid=FCX.US&back=IVW
RMD	RESMED INC	/etf/ea/ETZCW.djhtm?c=1&etfid=RMD.US&back=IVW
LHX	L3HARRIS TECHNOLOGIES INC	/etf/ea/ETZCW.djhtm?c=1&etfid=LHX.US&back=IVW
AMP	AMERIPRISE FINANCE INC	/etf/ea/ETZCW.djhtm?c=1&etfid=AMP.US&back=IVW
ALGN	ALIGN TECHNOLOGY INC	/etf/ea/ETZCW.djhtm?c=1&etfid=ALGN.US&back=IVW
MCHP	MICROCHIP TECHNOLOGY INC	/etf/ea/ETZCW.djhtm?c=1&etfid=MCHP.US&back=IVW
CPRT	COPART INC	/etf/ea/ETZCW.djhtm?c=1&etfid=CPRT.US&back=IVW
EXPD	EXPEDITORS INTERNATIONAL OF WASHIN	/etf/ea/ETZCW.djhtm?c=1&etfid=EXPD.US&back=IVW
MTD	METTLER TOLEDO INC	/etf/ea/ETZCW.djhtm?c=1&etfid=MTD.US&back=IVW
MNST	MONSTER BEVERAGE CORP	/etf/ea/ETZCW.djhtm?c=1&etfid=MNST.US&back=IVW
PKI	PERKINELMER INC	/etf/ea/ETZCW.djhtm?c=1&etfid=PKI.US&back=IVW
AJG	ARTHUR J GALLAGHER	/etf/ea/ETZCW.djhtm?c=1&etfid=AJG.US&back=IVW
CTAS	CINTAS CORP	/etf/ea/ETZCW.djhtm?c=1&etfid=CTAS.US&back=IVW
NDAQ	NASDAQ INC	/etf/ea/ETZCW.djhtm?c=1&etfid=NDAQ.US&back=IVW
ILMN	ILLUMINA INC	/etf/ea/ETZCW.djhtm?c=1&etfid=ILMN.US&back=IVW
HPQ	HP INC	/etf/ea/ETZCW.djhtm?c=1&etfid=HPQ.US&back=IVW
VRSK	VERISK ANALYTICS INC	/etf/ea/ETZCW.djhtm?c=1&etfid=VRSK.US&back=IVW
YUM	YUM BRANDS INC	/etf/ea/ETZCW.djhtm?c=1&etfid=YUM.US&back=IVW
HSY	HERSHEY FOODS	/etf/ea/ETZCW.djhtm?c=1&etfid=HSY.US&back=IVW
	DUKE REALTY REIT CORP	
HLT	HILTON WORLDWIDE HOLDINGS INC	/etf/ea/ETZCW.djhtm?c=1&etfid=HLT.US&back=IVW
ROK	ROCKWELL AUTOMATION INC	/etf/ea/ETZCW.djhtm?c=1&etfid=ROK.US&back=IVW
TWTR	TWITTER INC	/etf/ea/ETZCW.djhtm?c=1&etfid=TWTR.US&back=IVW
GNRC	GENERAC HOLDINGS INC	/etf/ea/ETZCW.djhtm?c=1&etfid=GNRC.US&back=IVW
FAST	FASTENAL	/etf/ea/ETZCW.djhtm?c=1&etfid=FAST.US&back=IVW
CPT	CAMDEN PROPERTY TRUST REIT	/etf/ea/ETZCW.djhtm?c=1&etfid=CPT.US&back=IVW
TDG	TRANSDIGM GROUP INC	/etf/ea/ETZCW.djhtm?c=1&etfid=TDG.US&back=IVW
TER	TERADYNE INC	/etf/ea/ETZCW.djhtm?c=1&etfid=TER.US&back=IVW
CDW	CDW CORP	/etf/ea/ETZCW.djhtm?c=1&etfid=CDW.US&back=IVW
POOL	POOL CORP	/etf/ea/ETZCW.djhtm?c=1&etfid=POOL.US&back=IVW
ETSY	ETSY INC	/etf/ea/ETZCW.djhtm?c=1&etfid=ETSY.US&back=IVW
ANSS	ANSYS INC	/etf/ea/ETZCW.djhtm?c=1&etfid=ANSS.US&back=IVW
WAT	WATERS CORP	/etf/ea/ETZCW.djhtm?c=1&etfid=WAT.US&back=IVW
RSG	REPUBLIC SERVICES INC	/etf/ea/ETZCW.djhtm?c=1&etfid=RSG.US&back=IVW
TECH	BIO TECHNE CORP	/etf/ea/ETZCW.djhtm?c=1&etfid=TECH.US&back=IVW
CF	CF INDUSTRIES HOLDINGS INC	/etf/ea/ETZCW.djhtm?c=1&etfid=CF.US&back=IVW
CBRE	CBRE GROUP INC CLASS A	/etf/ea/ETZCW.djhtm?c=1&etfid=CBRE.US&back=IVW
PAYC	PAYCOM SOFTWARE INC	/etf/ea/ETZCW.djhtm?c=1&etfid=PAYC.US&back=IVW
MLM	MARTIN MARIETTA MATERIALS INC	/etf/ea/ETZCW.djhtm?c=1&etfid=MLM.US&back=IVW
HOLX	HOLOGIC INC	/etf/ea/ETZCW.djhtm?c=1&etfid=HOLX.US&back=IVW
URI	UNITED RENTALS INC	/etf/ea/ETZCW.djhtm?c=1&etfid=URI.US&back=IVW
ULTA	ULTA BEAUTY INC	/etf/ea/ETZCW.djhtm?c=1&etfid=ULTA.US&back=IVW
OTIS	OTIS WORLDWIDE CORP	/etf/ea/ETZCW.djhtm?c=1&etfid=OTIS.US&back=IVW
DHI	D R HORTON INC	/etf/ea/ETZCW.djhtm?c=1&etfid=DHI.US&back=IVW
TTWO	TAKE TWO INTERACTIVE SOFTWARE INC	/etf/ea/ETZCW.djhtm?c=1&etfid=TTWO.US&back=IVW
RJF	RAYMOND JAMES INC	/etf/ea/ETZCW.djhtm?c=1&etfid=RJF.US&back=IVW
MAA	MID AMERICA APARTMENT COMMUNITIES	/etf/ea/ETZCW.djhtm?c=1&etfid=MAA.US&back=IVW
AVB	AVALONBAY COMMUNITIES REIT INC	/etf/ea/ETZCW.djhtm?c=1&etfid=AVB.US&back=IVW
OKE	ONEOK INC	/etf/ea/ETZCW.djhtm?c=1&etfid=OKE.US&back=IVW
ZBRA	ZEBRA TECHNOLOGIES CORP CLASS A	/etf/ea/ETZCW.djhtm?c=1&etfid=ZBRA.US&back=IVW
NTAP	NETAPP INC	/etf/ea/ETZCW.djhtm?c=1&etfid=NTAP.US&back=IVW
SEDG	SOLAREDGE TECHNOLOGIES INC	/etf/ea/ETZCW.djhtm?c=1&etfid=SEDG.US&back=IVW
	USD CASH	
SBNY	SIGNATURE BANK	/etf/ea/ETZCW.djhtm?c=1&etfid=SBNY.US&back=IVW
PWR	QUANTA SERVICES INC	/etf/ea/ETZCW.djhtm?c=1&etfid=PWR.US&back=IVW
LH	LABORATORY CORPORATION OF AMERICA	/etf/ea/ETZCW.djhtm?c=1&etfid=LH.US&back=IVW
WY	WEYERHAEUSER REIT	/etf/ea/ETZCW.djhtm?c=1&etfid=WY.US&back=IVW
VMC	VULCAN MATERIALS	/etf/ea/ETZCW.djhtm?c=1&etfid=VMC.US&back=IVW
APTV	APTIV PLC	/etf/ea/ETZCW.djhtm?c=1&etfid=APTV.US&back=IVW
CRL	CHARLES RIVER LABORATORIES INTERNA	/etf/ea/ETZCW.djhtm?c=1&etfid=CRL.US&back=IVW
BRO	BROWN & BROWN INC	/etf/ea/ETZCW.djhtm?c=1&etfid=BRO.US&back=IVW
MOH	MOLINA HEALTHCARE INC	/etf/ea/ETZCW.djhtm?c=1&etfid=MOH.US&back=IVW
NRG	NRG ENERGY INC	/etf/ea/ETZCW.djhtm?c=1&etfid=NRG.US&back=IVW
FDS	FACTSET RESEARCH SYSTEMS INC	/etf/ea/ETZCW.djhtm?c=1&etfid=FDS.US&back=IVW
STX	SEAGATE TECHNOLOGY HOLDINGS PLC	/etf/ea/ETZCW.djhtm?c=1&etfid=STX.US&back=IVW
TYL	TYLER TECHNOLOGIES INC	/etf/ea/ETZCW.djhtm?c=1&etfid=TYL.US&back=IVW
CTLT	CATALENTINC	/etf/ea/ETZCW.djhtm?c=1&etfid=CTLT.US&back=IVW
SYF	SYNCHRONY FINANCIAL	/etf/ea/ETZCW.djhtm?c=1&etfid=SYF.US&back=IVW
IRM	IRON MOUNTAIN INC	/etf/ea/ETZCW.djhtm?c=1&etfid=IRM.US&back=IVW
RF	REGIONS FINANCIAL CORP	/etf/ea/ETZCW.djhtm?c=1&etfid=RF.US&back=IVW
BR	BROADRIDGE FINANCIAL SOLUTIONS INC	/etf/ea/ETZCW.djhtm?c=1&etfid=BR.US&back=IVW
DPZ	DOMINOS PIZZA INC	/etf/ea/ETZCW.djhtm?c=1&etfid=DPZ.US&back=IVW
TRMB	TRIMBLE INC	/etf/ea/ETZCW.djhtm?c=1&etfid=TRMB.US&back=IVW
JBHT	JB HUNT TRANSPORT SERVICES INC	/etf/ea/ETZCW.djhtm?c=1&etfid=JBHT.US&back=IVW
STE	STERIS	/etf/ea/ETZCW.djhtm?c=1&etfid=STE.US&back=IVW
DOV	DOVER CORP	/etf/ea/ETZCW.djhtm?c=1&etfid=DOV.US&back=IVW
VRSN	VERISIGN INC	/etf/ea/ETZCW.djhtm?c=1&etfid=VRSN.US&back=IVW
AVY	AVERY DENNISON CORP	/etf/ea/ETZCW.djhtm?c=1&etfid=AVY.US&back=IVW
ESS	ESSEX PROPERTY TRUST REIT INC	/etf/ea/ETZCW.djhtm?c=1&etfid=ESS.US&back=IVW
KMX	CARMAX INC	/etf/ea/ETZCW.djhtm?c=1&etfid=KMX.US&back=IVW
UDR	UDR REIT INC	/etf/ea/ETZCW.djhtm?c=1&etfid=UDR.US&back=IVW
SWKS	SKYWORKS SOLUTIONS INC	/etf/ea/ETZCW.djhtm?c=1&etfid=SWKS.US&back=IVW
NDSN	NORDSON CORP	/etf/ea/ETZCW.djhtm?c=1&etfid=NDSN.US&back=IVW
CBOE	CBOE GLOBAL MARKETS INC	/etf/ea/ETZCW.djhtm?c=1&etfid=CBOE.US&back=IVW
APA	APA CORP	/etf/ea/ETZCW.djhtm?c=1&etfid=APA.US&back=IVW
J	JACOBS SOLUTIONS INC	/etf/ea/ETZCW.djhtm?c=1&etfid=J.US&back=IVW
GRMN	GARMIN LTD	/etf/ea/ETZCW.djhtm?c=1&etfid=GRMN.US&back=IVW
CINF	CINCINNATI FINANCIAL CORP	/etf/ea/ETZCW.djhtm?c=1&etfid=CINF.US&back=IVW
XYL	XYLEM INC	/etf/ea/ETZCW.djhtm?c=1&etfid=XYL.US&back=IVW
KDP	KEURIG DR PEPPER INC	/etf/ea/ETZCW.djhtm?c=1&etfid=KDP.US&back=IVW
DGX	QUEST DIAGNOSTICS INC	/etf/ea/ETZCW.djhtm?c=1&etfid=DGX.US&back=IVW
ABMD	ABIOMED INC	/etf/ea/ETZCW.djhtm?c=1&etfid=ABMD.US&back=IVW
IEX	IDEX CORP	/etf/ea/ETZCW.djhtm?c=1&etfid=IEX.US&back=IVW
AKAM	AKAMAI TECHNOLOGIES INC	/etf/ea/ETZCW.djhtm?c=1&etfid=AKAM.US&back=IVW
PTC	PTC INC	/etf/ea/ETZCW.djhtm?c=1&etfid=PTC.US&back=IVW
CZR	CAESARS ENTERTAINMENT INC	/etf/ea/ETZCW.djhtm?c=1&etfid=CZR.US&back=IVW
NVR	NVR INC	/etf/ea/ETZCW.djhtm?c=1&etfid=NVR.US&back=IVW
LKQ	LKQ CORP	/etf/ea/ETZCW.djhtm?c=1&etfid=LKQ.US&back=IVW
RHI	ROBERT HALF	/etf/ea/ETZCW.djhtm?c=1&etfid=RHI.US&back=IVW
BBWI	BATH AND BODY WORKS INC	/etf/ea/ETZCW.djhtm?c=1&etfid=BBWI.US&back=IVW
INCY	INCYTE CORP	/etf/ea/ETZCW.djhtm?c=1&etfid=INCY.US&back=IVW
BIO	BIO RAD LABORATORIES INC CLASS A	/etf/ea/ETZCW.djhtm?c=1&etfid=BIO.US&back=IVW
MAS	MASCO CORP	/etf/ea/ETZCW.djhtm?c=1&etfid=MAS.US&back=IVW
LYV	LIVE NATION ENTERTAINMENT INC	/etf/ea/ETZCW.djhtm?c=1&etfid=LYV.US&back=IVW
CE	CELANESE CORP	/etf/ea/ETZCW.djhtm?c=1&etfid=CE.US&back=IVW
FFIV	F5 INC	/etf/ea/ETZCW.djhtm?c=1&etfid=FFIV.US&back=IVW
QRVO	QORVO INC	/etf/ea/ETZCW.djhtm?c=1&etfid=QRVO.US&back=IVW
AAP	ADVANCE AUTO PARTS INC	/etf/ea/ETZCW.djhtm?c=1&etfid=AAP.US&back=IVW
CMA	COMERICA INC	/etf/ea/ETZCW.djhtm?c=1&etfid=CMA.US&back=IVW
MKTX	MARKETAXESS HOLDINGS INC	/etf/ea/ETZCW.djhtm?c=1&etfid=MKTX.US&back=IVW
PNR	PENTAIR	/etf/ea/ETZCW.djhtm?c=1&etfid=PNR.US&back=IVW
SEE	SEALED AIR CORP	/etf/ea/ETZCW.djhtm?c=1&etfid=SEE.US&back=IVW
ZION	ZIONS BANCORPORATION	/etf/ea/ETZCW.djhtm?c=1&etfid=ZION.US&back=IVW
AOS	A O SMITH CORP	/etf/ea/ETZCW.djhtm?c=1&etfid=AOS.US&back=IVW
FBHS	FORTUNE BRANDS HOME AND SECURITY I	/etf/ea/ETZCW.djhtm?c=1&etfid=FBHS.US&back=IVW
CDAY	CERIDIAN HCM HOLDING INC	/etf/ea/ETZCW.djhtm?c=1&etfid=CDAY.US&back=IVW
NWL	NEWELL BRANDS INC	/etf/ea/ETZCW.djhtm?c=1&etfid=NWL.US&back=IVW
ROL	ROLLINS INC	/etf/ea/ETZCW.djhtm?c=1&etfid=ROL.US&back=IVW
BEN	FRANKLIN RESOURCES INC	/etf/ea/ETZCW.djhtm?c=1&etfid=BEN.US&back=IVW
FRT	FEDERAL REALTY INVESTMENT TRUST RE	/etf/ea/ETZCW.djhtm?c=1&etfid=FRT.US&back=IVW
	CASH COLLATERAL MSFUT USD	
	S&P500 EMINI SEP 22	
