IYE
XOM	EXXON MOBIL CORP	/etf/ea/ETZCW.djhtm?c=1&etfid=XOM.US&back=IYE
CVX	CHEVRON CORP	/etf/ea/ETZCW.djhtm?c=1&etfid=CVX.US&back=IYE
COP	CONOCOPHILLIPS	/etf/ea/ETZCW.djhtm?c=1&etfid=COP.US&back=IYE
EOG	EOG RESOURCES INC	/etf/ea/ETZCW.djhtm?c=1&etfid=EOG.US&back=IYE
PXD	PIONEER NATURAL RESOURCE	/etf/ea/ETZCW.djhtm?c=1&etfid=PXD.US&back=IYE
OXY	OCCIDENTAL PETROLEUM CORP	/etf/ea/ETZCW.djhtm?c=1&etfid=OXY.US&back=IYE
MPC	MARATHON PETROLEUM CORP	/etf/ea/ETZCW.djhtm?c=1&etfid=MPC.US&back=IYE
SLB	SCHLUMBERGER NV	/etf/ea/ETZCW.djhtm?c=1&etfid=SLB.US&back=IYE
VLO	VALERO ENERGY CORP	/etf/ea/ETZCW.djhtm?c=1&etfid=VLO.US&back=IYE
DVN	DEVON ENERGY CORP	/etf/ea/ETZCW.djhtm?c=1&etfid=DVN.US&back=IYE
PSX	PHILLIPS 66	/etf/ea/ETZCW.djhtm?c=1&etfid=PSX.US&back=IYE
WMB	WILLIAMS INC	/etf/ea/ETZCW.djhtm?c=1&etfid=WMB.US&back=IYE
LNG	CHENIERE ENERGY INC	/etf/ea/ETZCW.djhtm?c=1&etfid=LNG.US&back=IYE
ENPH	ENPHASE ENERGY INC	/etf/ea/ETZCW.djhtm?c=1&etfid=ENPH.US&back=IYE
KMI	KINDER MORGAN INC	/etf/ea/ETZCW.djhtm?c=1&etfid=KMI.US&back=IYE
HES	HESS CORP	/etf/ea/ETZCW.djhtm?c=1&etfid=HES.US&back=IYE
OKE	ONEOK INC	/etf/ea/ETZCW.djhtm?c=1&etfid=OKE.US&back=IYE
HAL	HALLIBURTON	/etf/ea/ETZCW.djhtm?c=1&etfid=HAL.US&back=IYE
CTRA	COTERRA ENERGY INC	/etf/ea/ETZCW.djhtm?c=1&etfid=CTRA.US&back=IYE
FANG	DIAMONDBACK ENERGY INC	/etf/ea/ETZCW.djhtm?c=1&etfid=FANG.US&back=IYE
BKR	BAKER HUGHES CLASS A	/etf/ea/ETZCW.djhtm?c=1&etfid=BKR.US&back=IYE
MRO	MARATHON OIL CORP	/etf/ea/ETZCW.djhtm?c=1&etfid=MRO.US&back=IYE
EQT	EQT CORP	/etf/ea/ETZCW.djhtm?c=1&etfid=EQT.US&back=IYE
TRGP	TARGA RESOURCES CORP	/etf/ea/ETZCW.djhtm?c=1&etfid=TRGP.US&back=IYE
PLUG	PLUG POWER INC	/etf/ea/ETZCW.djhtm?c=1&etfid=PLUG.US&back=IYE
OVV	OVINTIV INC	/etf/ea/ETZCW.djhtm?c=1&etfid=OVV.US&back=IYE
FSLR	FIRST SOLAR INC	/etf/ea/ETZCW.djhtm?c=1&etfid=FSLR.US&back=IYE
APA	APA CORP	/etf/ea/ETZCW.djhtm?c=1&etfid=APA.US&back=IYE
CHK	CHESAPEAKE ENERGY CORP	/etf/ea/ETZCW.djhtm?c=1&etfid=CHK.US&back=IYE
AR	ANTERO RESOURCES CORP	/etf/ea/ETZCW.djhtm?c=1&etfid=AR.US&back=IYE
TPL	TEXAS PACIFIC LAND CORP	/etf/ea/ETZCW.djhtm?c=1&etfid=TPL.US&back=IYE
RRC	RANGE RESOURCES CORP	/etf/ea/ETZCW.djhtm?c=1&etfid=RRC.US&back=IYE
SWN	SOUTHWESTERN ENERGY	/etf/ea/ETZCW.djhtm?c=1&etfid=SWN.US&back=IYE
DINO	HF SINCLAIR CORP	/etf/ea/ETZCW.djhtm?c=1&etfid=DINO.US&back=IYE
NOV	NOV INC	/etf/ea/ETZCW.djhtm?c=1&etfid=NOV.US&back=IYE
PDCE	PDC ENERGY INC	/etf/ea/ETZCW.djhtm?c=1&etfid=PDCE.US&back=IYE
DTM	DT MIDSTREAM INC	/etf/ea/ETZCW.djhtm?c=1&etfid=DTM.US&back=IYE
	USD CASH	
AM	ANTERO MIDSTREAM CORP	/etf/ea/ETZCW.djhtm?c=1&etfid=AM.US&back=IYE
CHPT	CHARGEPOINT HOLDINGS INC CLASS A	/etf/ea/ETZCW.djhtm?c=1&etfid=CHPT.US&back=IYE
	BLK CSH FND TREASURY SL AGENCY	
NFE	NEW FORTRESS ENERGY INC CLASS A	/etf/ea/ETZCW.djhtm?c=1&etfid=NFE.US&back=IYE
CLR	CONTINENTAL RESOURCES INC	/etf/ea/ETZCW.djhtm?c=1&etfid=CLR.US&back=IYE
EVA	ENVIVA INC	/etf/ea/ETZCW.djhtm?c=1&etfid=EVA.US&back=IYE
	CASH COLLATERAL USD WFFUT	
	EMINI ENERGY SELECT SECTOR SEP 22	
