IYH
UNH	UNITEDHEALTH GROUP INC	/etf/ea/ETZCW.djhtm?c=1&etfid=UNH.US&back=IYH
JNJ	JOHNSON & JOHNSON	/etf/ea/ETZCW.djhtm?c=1&etfid=JNJ.US&back=IYH
PFE	PFIZER INC	/etf/ea/ETZCW.djhtm?c=1&etfid=PFE.US&back=IYH
LLY	ELI LILLY	/etf/ea/ETZCW.djhtm?c=1&etfid=LLY.US&back=IYH
ABBV	ABBVIE INC	/etf/ea/ETZCW.djhtm?c=1&etfid=ABBV.US&back=IYH
MRK	MERCK & CO INC	/etf/ea/ETZCW.djhtm?c=1&etfid=MRK.US&back=IYH
TMO	THERMO FISHER SCIENTIFIC INC	/etf/ea/ETZCW.djhtm?c=1&etfid=TMO.US&back=IYH
ABT	ABBOTT LABORATORIES	/etf/ea/ETZCW.djhtm?c=1&etfid=ABT.US&back=IYH
DHR	DANAHER CORP	/etf/ea/ETZCW.djhtm?c=1&etfid=DHR.US&back=IYH
BMY	BRISTOL MYERS SQUIBB	/etf/ea/ETZCW.djhtm?c=1&etfid=BMY.US&back=IYH
AMGN	AMGEN INC	/etf/ea/ETZCW.djhtm?c=1&etfid=AMGN.US&back=IYH
MDT	MEDTRONIC PLC	/etf/ea/ETZCW.djhtm?c=1&etfid=MDT.US&back=IYH
ELV	ELEVANCE HEALTH INC	/etf/ea/ETZCW.djhtm?c=1&etfid=ELV.US&back=IYH
CI	CIGNA CORP	/etf/ea/ETZCW.djhtm?c=1&etfid=CI.US&back=IYH
GILD	GILEAD SCIENCES INC	/etf/ea/ETZCW.djhtm?c=1&etfid=GILD.US&back=IYH
ZTS	ZOETIS INC CLASS A	/etf/ea/ETZCW.djhtm?c=1&etfid=ZTS.US&back=IYH
ISRG	INTUITIVE SURGICAL INC	/etf/ea/ETZCW.djhtm?c=1&etfid=ISRG.US&back=IYH
SYK	STRYKER CORP	/etf/ea/ETZCW.djhtm?c=1&etfid=SYK.US&back=IYH
VRTX	VERTEX PHARMACEUTICALS INC	/etf/ea/ETZCW.djhtm?c=1&etfid=VRTX.US&back=IYH
BDX	BECTON DICKINSON	/etf/ea/ETZCW.djhtm?c=1&etfid=BDX.US&back=IYH
HUM	HUMANA INC	/etf/ea/ETZCW.djhtm?c=1&etfid=HUM.US&back=IYH
REGN	REGENERON PHARMACEUTICALS INC	/etf/ea/ETZCW.djhtm?c=1&etfid=REGN.US&back=IYH
BSX	BOSTON SCIENTIFIC CORP	/etf/ea/ETZCW.djhtm?c=1&etfid=BSX.US&back=IYH
EW	EDWARDS LIFESCIENCES CORP	/etf/ea/ETZCW.djhtm?c=1&etfid=EW.US&back=IYH
CNC	CENTENE CORP	/etf/ea/ETZCW.djhtm?c=1&etfid=CNC.US&back=IYH
MRNA	MODERNA INC	/etf/ea/ETZCW.djhtm?c=1&etfid=MRNA.US&back=IYH
HCA	HCA HEALTHCARE INC	/etf/ea/ETZCW.djhtm?c=1&etfid=HCA.US&back=IYH
IQV	IQVIA HOLDINGS INC	/etf/ea/ETZCW.djhtm?c=1&etfid=IQV.US&back=IYH
A	AGILENT TECHNOLOGIES INC	/etf/ea/ETZCW.djhtm?c=1&etfid=A.US&back=IYH
DXCM	DEXCOM INC	/etf/ea/ETZCW.djhtm?c=1&etfid=DXCM.US&back=IYH
RMD	RESMED INC	/etf/ea/ETZCW.djhtm?c=1&etfid=RMD.US&back=IYH
ILMN	ILLUMINA INC	/etf/ea/ETZCW.djhtm?c=1&etfid=ILMN.US&back=IYH
IDXX	IDEXX LABORATORIES INC	/etf/ea/ETZCW.djhtm?c=1&etfid=IDXX.US&back=IYH
BAX	BAXTER INTERNATIONAL INC	/etf/ea/ETZCW.djhtm?c=1&etfid=BAX.US&back=IYH
BIIB	BIOGEN INC	/etf/ea/ETZCW.djhtm?c=1&etfid=BIIB.US&back=IYH
VEEV	VEEVA SYSTEMS INC CLASS A	/etf/ea/ETZCW.djhtm?c=1&etfid=VEEV.US&back=IYH
ALNY	ALNYLAM PHARMACEUTICALS INC	/etf/ea/ETZCW.djhtm?c=1&etfid=ALNY.US&back=IYH
ZBH	ZIMMER BIOMET HOLDINGS INC	/etf/ea/ETZCW.djhtm?c=1&etfid=ZBH.US&back=IYH
WST	WEST PHARMACEUTICAL SERVICES INC	/etf/ea/ETZCW.djhtm?c=1&etfid=WST.US&back=IYH
SGEN	SEAGEN INC	/etf/ea/ETZCW.djhtm?c=1&etfid=SGEN.US&back=IYH
LH	LABORATORY CORPORATION OF AMERICA	/etf/ea/ETZCW.djhtm?c=1&etfid=LH.US&back=IYH
MOH	MOLINA HEALTHCARE INC	/etf/ea/ETZCW.djhtm?c=1&etfid=MOH.US&back=IYH
CAH	CARDINAL HEALTH INC	/etf/ea/ETZCW.djhtm?c=1&etfid=CAH.US&back=IYH
ALGN	ALIGN TECHNOLOGY INC	/etf/ea/ETZCW.djhtm?c=1&etfid=ALGN.US&back=IYH
PODD	INSULET CORP	/etf/ea/ETZCW.djhtm?c=1&etfid=PODD.US&back=IYH
STE	STERIS	/etf/ea/ETZCW.djhtm?c=1&etfid=STE.US&back=IYH
PKI	PERKINELMER INC	/etf/ea/ETZCW.djhtm?c=1&etfid=PKI.US&back=IYH
HOLX	HOLOGIC INC	/etf/ea/ETZCW.djhtm?c=1&etfid=HOLX.US&back=IYH
BMRN	BIOMARIN PHARMACEUTICAL INC	/etf/ea/ETZCW.djhtm?c=1&etfid=BMRN.US&back=IYH
RPRX	ROYALTY PHARMA PLC CLASS A	/etf/ea/ETZCW.djhtm?c=1&etfid=RPRX.US&back=IYH
AVTR	AVANTOR INC	/etf/ea/ETZCW.djhtm?c=1&etfid=AVTR.US&back=IYH
CTLT	CATALENTINC	/etf/ea/ETZCW.djhtm?c=1&etfid=CTLT.US&back=IYH
DGX	QUEST DIAGNOSTICS INC	/etf/ea/ETZCW.djhtm?c=1&etfid=DGX.US&back=IYH
COO	COOPER INC	/etf/ea/ETZCW.djhtm?c=1&etfid=COO.US&back=IYH
HZNP	HORIZON THERAPEUTICS PUBLIC PLC	/etf/ea/ETZCW.djhtm?c=1&etfid=HZNP.US&back=IYH
TECH	BIO TECHNE CORP	/etf/ea/ETZCW.djhtm?c=1&etfid=TECH.US&back=IYH
INCY	INCYTE CORP	/etf/ea/ETZCW.djhtm?c=1&etfid=INCY.US&back=IYH
RGEN	REPLIGEN CORP	/etf/ea/ETZCW.djhtm?c=1&etfid=RGEN.US&back=IYH
ABMD	ABIOMED INC	/etf/ea/ETZCW.djhtm?c=1&etfid=ABMD.US&back=IYH
VTRS	VIATRIS INC	/etf/ea/ETZCW.djhtm?c=1&etfid=VTRS.US&back=IYH
TFX	TELEFLEX INC	/etf/ea/ETZCW.djhtm?c=1&etfid=TFX.US&back=IYH
BIO	BIO RAD LABORATORIES INC CLASS A	/etf/ea/ETZCW.djhtm?c=1&etfid=BIO.US&back=IYH
CRL	CHARLES RIVER LABORATORIES INTERNA	/etf/ea/ETZCW.djhtm?c=1&etfid=CRL.US&back=IYH
QGEN	QIAGEN NV	/etf/ea/ETZCW.djhtm?c=1&etfid=QGEN.US&back=IYH
UTHR	UNITED THERAPEUTICS CORP	/etf/ea/ETZCW.djhtm?c=1&etfid=UTHR.US&back=IYH
HSIC	HENRY SCHEIN INC	/etf/ea/ETZCW.djhtm?c=1&etfid=HSIC.US&back=IYH
NBIX	NEUROCRINE BIOSCIENCES INC	/etf/ea/ETZCW.djhtm?c=1&etfid=NBIX.US&back=IYH
JAZZ	JAZZ PHARMACEUTICALS PLC	/etf/ea/ETZCW.djhtm?c=1&etfid=JAZZ.US&back=IYH
SRPT	SAREPTA THERAPEUTICS INC	/etf/ea/ETZCW.djhtm?c=1&etfid=SRPT.US&back=IYH
NVCR	NOVOCURE LTD	/etf/ea/ETZCW.djhtm?c=1&etfid=NVCR.US&back=IYH
MASI	MASIMO CORP	/etf/ea/ETZCW.djhtm?c=1&etfid=MASI.US&back=IYH
ACHC	ACADIA HEALTHCARE COMPANY INC	/etf/ea/ETZCW.djhtm?c=1&etfid=ACHC.US&back=IYH
OGN	ORGANON	/etf/ea/ETZCW.djhtm?c=1&etfid=OGN.US&back=IYH
XRAY	DENTSPLY SIRONA INC	/etf/ea/ETZCW.djhtm?c=1&etfid=XRAY.US&back=IYH
CHE	CHEMED CORP	/etf/ea/ETZCW.djhtm?c=1&etfid=CHE.US&back=IYH
ELAN	ELANCO ANIMAL HEALTH INC	/etf/ea/ETZCW.djhtm?c=1&etfid=ELAN.US&back=IYH
UHS	UNIVERSAL HEALTH SERVICES INC CLAS	/etf/ea/ETZCW.djhtm?c=1&etfid=UHS.US&back=IYH
EXAS	EXACT SCIENCES CORP	/etf/ea/ETZCW.djhtm?c=1&etfid=EXAS.US&back=IYH
	BLK CSH FND TREASURY SL AGENCY	
SYNH	SYNEOS HEALTH INC CLASS A	/etf/ea/ETZCW.djhtm?c=1&etfid=SYNH.US&back=IYH
BRKR	BRUKER CORP	/etf/ea/ETZCW.djhtm?c=1&etfid=BRKR.US&back=IYH
NVST	ENVISTA HOLDINGS CORP	/etf/ea/ETZCW.djhtm?c=1&etfid=NVST.US&back=IYH
IONS	IONIS PHARMACEUTICALS INC	/etf/ea/ETZCW.djhtm?c=1&etfid=IONS.US&back=IYH
THC	TENET HEALTHCARE CORP	/etf/ea/ETZCW.djhtm?c=1&etfid=THC.US&back=IYH
PEN	PENUMBRA INC	/etf/ea/ETZCW.djhtm?c=1&etfid=PEN.US&back=IYH
EXEL	EXELIXIS INC	/etf/ea/ETZCW.djhtm?c=1&etfid=EXEL.US&back=IYH
PRGO	PERRIGO PLC	/etf/ea/ETZCW.djhtm?c=1&etfid=PRGO.US&back=IYH
TDOC	TELADOC HEALTH INC	/etf/ea/ETZCW.djhtm?c=1&etfid=TDOC.US&back=IYH
DVA	DAVITA INC	/etf/ea/ETZCW.djhtm?c=1&etfid=DVA.US&back=IYH
GH	GUARDANT HEALTH INC	/etf/ea/ETZCW.djhtm?c=1&etfid=GH.US&back=IYH
EHC	ENCOMPASS HEALTH CORP	/etf/ea/ETZCW.djhtm?c=1&etfid=EHC.US&back=IYH
GMED	GLOBUS MEDICAL INC CLASS A	/etf/ea/ETZCW.djhtm?c=1&etfid=GMED.US&back=IYH
	USD CASH	
NTRA	NATERA INC	/etf/ea/ETZCW.djhtm?c=1&etfid=NTRA.US&back=IYH
PINC	PREMIER INC CLASS A	/etf/ea/ETZCW.djhtm?c=1&etfid=PINC.US&back=IYH
QDEL	QUIDELORTHO CORP	/etf/ea/ETZCW.djhtm?c=1&etfid=QDEL.US&back=IYH
AGL	AGILON HEALTH	/etf/ea/ETZCW.djhtm?c=1&etfid=AGL.US&back=IYH
AMED	AMEDISYS INC	/etf/ea/ETZCW.djhtm?c=1&etfid=AMED.US&back=IYH
MRTX	MIRATI THERAPEUTICS INC	/etf/ea/ETZCW.djhtm?c=1&etfid=MRTX.US&back=IYH
IART	INTEGRA LIFESCIENCES HOLDINGS CORP	/etf/ea/ETZCW.djhtm?c=1&etfid=IART.US&back=IYH
ICUI	ICU MEDICAL INC	/etf/ea/ETZCW.djhtm?c=1&etfid=ICUI.US&back=IYH
RARE	ULTRAGENYX PHARMACEUTICAL INC	/etf/ea/ETZCW.djhtm?c=1&etfid=RARE.US&back=IYH
DOCS	DOXIMITY INC CLASS A	/etf/ea/ETZCW.djhtm?c=1&etfid=DOCS.US&back=IYH
OSH	OAK STREET HEALTH INC	/etf/ea/ETZCW.djhtm?c=1&etfid=OSH.US&back=IYH
TXG	10X GENOMICS INC CLASS A	/etf/ea/ETZCW.djhtm?c=1&etfid=TXG.US&back=IYH
TNDM	TANDEM DIABETES CARE INC	/etf/ea/ETZCW.djhtm?c=1&etfid=TNDM.US&back=IYH
NVAX	NOVAVAX INC	/etf/ea/ETZCW.djhtm?c=1&etfid=NVAX.US&back=IYH
ENOV	ENOVIS CORP	/etf/ea/ETZCW.djhtm?c=1&etfid=ENOV.US&back=IYH
MRVI	MARAVAI LIFESCIENCES HOLDINGS INC	/etf/ea/ETZCW.djhtm?c=1&etfid=MRVI.US&back=IYH
DNA	GINKGO BIOWORKS HOLDINGS INC CLASS	/etf/ea/ETZCW.djhtm?c=1&etfid=DNA.US&back=IYH
SGFY	SIGNIFY HEALTH INC CLASS A	/etf/ea/ETZCW.djhtm?c=1&etfid=SGFY.US&back=IYH
CERT	CERTARA INC	/etf/ea/ETZCW.djhtm?c=1&etfid=CERT.US&back=IYH
SHC	SOTERA HEALTH COMPANY	/etf/ea/ETZCW.djhtm?c=1&etfid=SHC.US&back=IYH
EHAB	ENHABIT INC	/etf/ea/ETZCW.djhtm?c=1&etfid=EHAB.US&back=IYH
	CASH COLLATERAL USD WFFUT	
	E-MINI HEALTH CARE SECTOR SEP 22	
