IYM
LIN	LINDE PLC	/etf/ea/ETZCW.djhtm?c=1&etfid=LIN.US&back=IYM
APD	AIR PRODUCTS AND CHEMICALS INC	/etf/ea/ETZCW.djhtm?c=1&etfid=APD.US&back=IYM
FCX	FREEPORT MCMORAN INC	/etf/ea/ETZCW.djhtm?c=1&etfid=FCX.US&back=IYM
ECL	ECOLAB INC	/etf/ea/ETZCW.djhtm?c=1&etfid=ECL.US&back=IYM
DOW	DOW INC	/etf/ea/ETZCW.djhtm?c=1&etfid=DOW.US&back=IYM
NUE	NUCOR CORP	/etf/ea/ETZCW.djhtm?c=1&etfid=NUE.US&back=IYM
NEM	NEWMONT	/etf/ea/ETZCW.djhtm?c=1&etfid=NEM.US&back=IYM
ALB	ALBEMARLE CORP	/etf/ea/ETZCW.djhtm?c=1&etfid=ALB.US&back=IYM
FAST	FASTENAL	/etf/ea/ETZCW.djhtm?c=1&etfid=FAST.US&back=IYM
IFF	INTERNATIONAL FLAVORS & FRAGRANCES	/etf/ea/ETZCW.djhtm?c=1&etfid=IFF.US&back=IYM
CF	CF INDUSTRIES HOLDINGS INC	/etf/ea/ETZCW.djhtm?c=1&etfid=CF.US&back=IYM
LYB	LYONDELLBASELL INDUSTRIES NV CLASS	/etf/ea/ETZCW.djhtm?c=1&etfid=LYB.US&back=IYM
MOS	MOSAIC	/etf/ea/ETZCW.djhtm?c=1&etfid=MOS.US&back=IYM
IP	INTERNATIONAL PAPER	/etf/ea/ETZCW.djhtm?c=1&etfid=IP.US&back=IYM
AVY	AVERY DENNISON CORP	/etf/ea/ETZCW.djhtm?c=1&etfid=AVY.US&back=IYM
STLD	STEEL DYNAMICS INC	/etf/ea/ETZCW.djhtm?c=1&etfid=STLD.US&back=IYM
FMC	FMC CORP	/etf/ea/ETZCW.djhtm?c=1&etfid=FMC.US&back=IYM
CE	CELANESE CORP	/etf/ea/ETZCW.djhtm?c=1&etfid=CE.US&back=IYM
EMN	EASTMAN CHEMICAL	/etf/ea/ETZCW.djhtm?c=1&etfid=EMN.US&back=IYM
RS	RELIANCE STEEL & ALUMINUM	/etf/ea/ETZCW.djhtm?c=1&etfid=RS.US&back=IYM
AA	ALCOA CORP	/etf/ea/ETZCW.djhtm?c=1&etfid=AA.US&back=IYM
CLF	CLEVELAND CLIFFS INC	/etf/ea/ETZCW.djhtm?c=1&etfid=CLF.US&back=IYM
OLN	OLIN CORP	/etf/ea/ETZCW.djhtm?c=1&etfid=OLN.US&back=IYM
RGLD	ROYAL GOLD INC	/etf/ea/ETZCW.djhtm?c=1&etfid=RGLD.US&back=IYM
X	US STEEL CORP	/etf/ea/ETZCW.djhtm?c=1&etfid=X.US&back=IYM
HUN	HUNTSMAN CORP	/etf/ea/ETZCW.djhtm?c=1&etfid=HUN.US&back=IYM
VVV	VALVOLINE INC	/etf/ea/ETZCW.djhtm?c=1&etfid=VVV.US&back=IYM
CC	CHEMOURS	/etf/ea/ETZCW.djhtm?c=1&etfid=CC.US&back=IYM
ASH	ASHLAND INC	/etf/ea/ETZCW.djhtm?c=1&etfid=ASH.US&back=IYM
HXL	HEXCEL CORP	/etf/ea/ETZCW.djhtm?c=1&etfid=HXL.US&back=IYM
ESI	ELEMENT SOLUTIONS INC	/etf/ea/ETZCW.djhtm?c=1&etfid=ESI.US&back=IYM
UNVR	UNIVAR SOLUTIONS INC	/etf/ea/ETZCW.djhtm?c=1&etfid=UNVR.US&back=IYM
SCCO	SOUTHERN COPPER CORP	/etf/ea/ETZCW.djhtm?c=1&etfid=SCCO.US&back=IYM
TKR	TIMKEN	/etf/ea/ETZCW.djhtm?c=1&etfid=TKR.US&back=IYM
WLK	WESTLAKE CORP	/etf/ea/ETZCW.djhtm?c=1&etfid=WLK.US&back=IYM
MP	MP MATERIALS CORP CLASS A	/etf/ea/ETZCW.djhtm?c=1&etfid=MP.US&back=IYM
SSRM	SSR MINING INC	/etf/ea/ETZCW.djhtm?c=1&etfid=SSRM.US&back=IYM
SMG	SCOTTS MIRACLE GRO	/etf/ea/ETZCW.djhtm?c=1&etfid=SMG.US&back=IYM
NEU	NEWMARKET CORP	/etf/ea/ETZCW.djhtm?c=1&etfid=NEU.US&back=IYM
	BLK CSH FND TREASURY SL AGENCY	
	USD CASH	
	CASH COLLATERAL USD WFFUT	
