IYR
AMT	AMERICAN TOWER REIT CORP	/etf/ea/ETZCW.djhtm?c=1&etfid=AMT.US&back=IYR
PLD	PROLOGIS REIT INC	/etf/ea/ETZCW.djhtm?c=1&etfid=PLD.US&back=IYR
CCI	CROWN CASTLE INC	/etf/ea/ETZCW.djhtm?c=1&etfid=CCI.US&back=IYR
EQIX	EQUINIX REIT INC	/etf/ea/ETZCW.djhtm?c=1&etfid=EQIX.US&back=IYR
PSA	PUBLIC STORAGE REIT	/etf/ea/ETZCW.djhtm?c=1&etfid=PSA.US&back=IYR
O	REALTY INCOME REIT CORP	/etf/ea/ETZCW.djhtm?c=1&etfid=O.US&back=IYR
DLR	DIGITAL REALTY TRUST REIT INC	/etf/ea/ETZCW.djhtm?c=1&etfid=DLR.US&back=IYR
SBAC	SBA COMMUNICATIONS REIT CORP CLASS	/etf/ea/ETZCW.djhtm?c=1&etfid=SBAC.US&back=IYR
WELL	WELLTOWER	/etf/ea/ETZCW.djhtm?c=1&etfid=WELL.US&back=IYR
SPG	SIMON PROPERTY GROUP REIT INC	/etf/ea/ETZCW.djhtm?c=1&etfid=SPG.US&back=IYR
VICI	VICI PPTYS INC	/etf/ea/ETZCW.djhtm?c=1&etfid=VICI.US&back=IYR
AVB	AVALONBAY COMMUNITIES REIT INC	/etf/ea/ETZCW.djhtm?c=1&etfid=AVB.US&back=IYR
CSGP	COSTAR GROUP INC	/etf/ea/ETZCW.djhtm?c=1&etfid=CSGP.US&back=IYR
EXR	EXTRA SPACE STORAGE REIT INC	/etf/ea/ETZCW.djhtm?c=1&etfid=EXR.US&back=IYR
CBRE	CBRE GROUP INC CLASS A	/etf/ea/ETZCW.djhtm?c=1&etfid=CBRE.US&back=IYR
WY	WEYERHAEUSER REIT	/etf/ea/ETZCW.djhtm?c=1&etfid=WY.US&back=IYR
EQR	EQUITY RESIDENTIAL REIT	/etf/ea/ETZCW.djhtm?c=1&etfid=EQR.US&back=IYR
ARE	ALEXANDRIA REAL ESTATE EQUITIES RE	/etf/ea/ETZCW.djhtm?c=1&etfid=ARE.US&back=IYR
	DUKE REALTY REIT CORP	
INVH	INVITATION HOMES INC	/etf/ea/ETZCW.djhtm?c=1&etfid=INVH.US&back=IYR
VTR	VENTAS REIT INC	/etf/ea/ETZCW.djhtm?c=1&etfid=VTR.US&back=IYR
MAA	MID AMERICA APARTMENT COMMUNITIES	/etf/ea/ETZCW.djhtm?c=1&etfid=MAA.US&back=IYR
SUI	SUN COMMUNITIES REIT INC	/etf/ea/ETZCW.djhtm?c=1&etfid=SUI.US&back=IYR
ESS	ESSEX PROPERTY TRUST REIT INC	/etf/ea/ETZCW.djhtm?c=1&etfid=ESS.US&back=IYR
WPC	W. P. CAREY REIT INC	/etf/ea/ETZCW.djhtm?c=1&etfid=WPC.US&back=IYR
IRM	IRON MOUNTAIN INC	/etf/ea/ETZCW.djhtm?c=1&etfid=IRM.US&back=IYR
PEAK	HEALTHPEAK PROPERTIES INC	/etf/ea/ETZCW.djhtm?c=1&etfid=PEAK.US&back=IYR
CPT	CAMDEN PROPERTY TRUST REIT	/etf/ea/ETZCW.djhtm?c=1&etfid=CPT.US&back=IYR
UDR	UDR REIT INC	/etf/ea/ETZCW.djhtm?c=1&etfid=UDR.US&back=IYR
KIM	KIMCO REALTY REIT CORP	/etf/ea/ETZCW.djhtm?c=1&etfid=KIM.US&back=IYR
HST	HOST HOTELS & RESORTS REIT INC	/etf/ea/ETZCW.djhtm?c=1&etfid=HST.US&back=IYR
ELS	EQUITY LIFESTYLE PROPERTIES REIT I	/etf/ea/ETZCW.djhtm?c=1&etfid=ELS.US&back=IYR
GLPI	GAMING AND LEISURE PROPERTIES REIT	/etf/ea/ETZCW.djhtm?c=1&etfid=GLPI.US&back=IYR
BXP	BOSTON PROPERTIES REIT INC	/etf/ea/ETZCW.djhtm?c=1&etfid=BXP.US&back=IYR
LSI	LIFE STORAGE INC	/etf/ea/ETZCW.djhtm?c=1&etfid=LSI.US&back=IYR
NLY	ANNALY CAPITAL MANAGEMENT REIT INC	/etf/ea/ETZCW.djhtm?c=1&etfid=NLY.US&back=IYR
AMH	AMERICAN HOMESRENT REIT CLASS A	/etf/ea/ETZCW.djhtm?c=1&etfid=AMH.US&back=IYR
CUBE	CUBESMART REIT	/etf/ea/ETZCW.djhtm?c=1&etfid=CUBE.US&back=IYR
REXR	REXFORD INDUSTRIAL REALTY REIT INC	/etf/ea/ETZCW.djhtm?c=1&etfid=REXR.US&back=IYR
REG	REGENCY CENTERS REIT CORP	/etf/ea/ETZCW.djhtm?c=1&etfid=REG.US&back=IYR
HR	HEALTHCARE REALTY TRUST INC CLASS	/etf/ea/ETZCW.djhtm?c=1&etfid=HR.US&back=IYR
MPW	MEDICAL PROPERTIES TRUST REIT INC	/etf/ea/ETZCW.djhtm?c=1&etfid=MPW.US&back=IYR
JLL	JONES LANG LASALLE INC	/etf/ea/ETZCW.djhtm?c=1&etfid=JLL.US&back=IYR
LAMR	LAMAR ADVERTISING COMPANYCLAS	/etf/ea/ETZCW.djhtm?c=1&etfid=LAMR.US&back=IYR
COLD	AMERICOLD REALTY INC TRUST	/etf/ea/ETZCW.djhtm?c=1&etfid=COLD.US&back=IYR
NNN	NATIONAL RETAIL PROPERTIES REIT IN	/etf/ea/ETZCW.djhtm?c=1&etfid=NNN.US&back=IYR
OHI	OMEGA HEALTHCARE INVESTORS REIT IN	/etf/ea/ETZCW.djhtm?c=1&etfid=OHI.US&back=IYR
FRT	FEDERAL REALTY INVESTMENT TRUST RE	/etf/ea/ETZCW.djhtm?c=1&etfid=FRT.US&back=IYR
STWD	STARWOOD PROPERTY TRUST REIT INC	/etf/ea/ETZCW.djhtm?c=1&etfid=STWD.US&back=IYR
EGP	EASTGROUP PROPERTIES REIT INC	/etf/ea/ETZCW.djhtm?c=1&etfid=EGP.US&back=IYR
STOR	STORE CAPITAL CORP	/etf/ea/ETZCW.djhtm?c=1&etfid=STOR.US&back=IYR
FR	FIRST INDUSTRIAL REALTY TRUST INC	/etf/ea/ETZCW.djhtm?c=1&etfid=FR.US&back=IYR
BRX	BRIXMOR PROPERTY GROUP REIT INC	/etf/ea/ETZCW.djhtm?c=1&etfid=BRX.US&back=IYR
AIRC	APARTMENT INCOME REIT CORP	/etf/ea/ETZCW.djhtm?c=1&etfid=AIRC.US&back=IYR
AGNC	AGNC INVESTMENT REIT CORP	/etf/ea/ETZCW.djhtm?c=1&etfid=AGNC.US&back=IYR
STAG	STAG INDUSTRIAL REIT INC	/etf/ea/ETZCW.djhtm?c=1&etfid=STAG.US&back=IYR
SRC	SPIRIT REALTY CAPITAL REIT INC	/etf/ea/ETZCW.djhtm?c=1&etfid=SRC.US&back=IYR
Z	ZILLOW GROUP INC CLASS C	/etf/ea/ETZCW.djhtm?c=1&etfid=Z.US&back=IYR
RYN	RAYONIER REIT INC	/etf/ea/ETZCW.djhtm?c=1&etfid=RYN.US&back=IYR
KRC	KILROY REALTY REIT CORP	/etf/ea/ETZCW.djhtm?c=1&etfid=KRC.US&back=IYR
BXMT	BLACKSTONE MORTGAGE TRUST REIT CLA	/etf/ea/ETZCW.djhtm?c=1&etfid=BXMT.US&back=IYR
RITM	RITHM CAPITAL CORP	/etf/ea/ETZCW.djhtm?c=1&etfid=RITM.US&back=IYR
NSA	NATIONAL STORAGE AFFILIATES TRUST	/etf/ea/ETZCW.djhtm?c=1&etfid=NSA.US&back=IYR
VNO	VORNADO REALTY TRUST REIT	/etf/ea/ETZCW.djhtm?c=1&etfid=VNO.US&back=IYR
CUZ	COUSINS PROPERTIES REIT INC	/etf/ea/ETZCW.djhtm?c=1&etfid=CUZ.US&back=IYR
DOC	PHYSICIANS REALTY TRUST REIT	/etf/ea/ETZCW.djhtm?c=1&etfid=DOC.US&back=IYR
SBRA	SABRA HEALTH CARE REIT INC	/etf/ea/ETZCW.djhtm?c=1&etfid=SBRA.US&back=IYR
DEI	DOUGLAS EMMETT REIT INC	/etf/ea/ETZCW.djhtm?c=1&etfid=DEI.US&back=IYR
PCH	POTLATCHDELTIC CORP	/etf/ea/ETZCW.djhtm?c=1&etfid=PCH.US&back=IYR
HIW	HIGHWOODS PROPERTIES REIT INC	/etf/ea/ETZCW.djhtm?c=1&etfid=HIW.US&back=IYR
NHI	NATIONAL HEALTH INVESTORS REIT INC	/etf/ea/ETZCW.djhtm?c=1&etfid=NHI.US&back=IYR
EQC	EQUITY COMMONWEALTH REIT	/etf/ea/ETZCW.djhtm?c=1&etfid=EQC.US&back=IYR
OFC	CORPORATE OFFICE PROPERTIES TRUST	/etf/ea/ETZCW.djhtm?c=1&etfid=OFC.US&back=IYR
LXP	LXP INDUSTRIAL TRUST	/etf/ea/ETZCW.djhtm?c=1&etfid=LXP.US&back=IYR
SLG	SL GREEN REALTY REIT CORP	/etf/ea/ETZCW.djhtm?c=1&etfid=SLG.US&back=IYR
HHC	HOWARD HUGHES CORP	/etf/ea/ETZCW.djhtm?c=1&etfid=HHC.US&back=IYR
JBGS	JBG SMITH PROPERTIES	/etf/ea/ETZCW.djhtm?c=1&etfid=JBGS.US&back=IYR
	BLK CSH FND TREASURY SL AGENCY	
HPP	HUDSON PACIFIC PROPERTIES REIT INC	/etf/ea/ETZCW.djhtm?c=1&etfid=HPP.US&back=IYR
OPEN	OPENDOOR TECHNOLOGIES INC	/etf/ea/ETZCW.djhtm?c=1&etfid=OPEN.US&back=IYR
ZG	ZILLOW GROUP INC CLASS A	/etf/ea/ETZCW.djhtm?c=1&etfid=ZG.US&back=IYR
RDFN	REDFIN CORP	/etf/ea/ETZCW.djhtm?c=1&etfid=RDFN.US&back=IYR
ONL	ORION OFFICE REIT INC	/etf/ea/ETZCW.djhtm?c=1&etfid=ONL.US&back=IYR
	USD CASH	
	CASH COLLATERAL USD MLPFT	
COMP	COMPASS INC CLASS A	/etf/ea/ETZCW.djhtm?c=1&etfid=COMP.US&back=IYR
	DOW JONES US REAL ESTATE SEP 22	
