KRE
FCNCA	First Citizens BancShares Inc. Class A	/etf/ea/ETZCW.djhtm?c=1&etfid=FCNCA.US&back=KRE
SI	Silvergate Capital Corp. Class A	/etf/ea/ETZCW.djhtm?c=1&etfid=SI.US&back=KRE
CFR	Cullen/Frost Bankers Inc.	/etf/ea/ETZCW.djhtm?c=1&etfid=CFR.US&back=KRE
ONB	Old National Bancorp	/etf/ea/ETZCW.djhtm?c=1&etfid=ONB.US&back=KRE
MTB	M&T Bank Corporation	/etf/ea/ETZCW.djhtm?c=1&etfid=MTB.US&back=KRE
PNFP	Pinnacle Financial Partners Inc.	/etf/ea/ETZCW.djhtm?c=1&etfid=PNFP.US&back=KRE
EWBC	East West Bancorp Inc.	/etf/ea/ETZCW.djhtm?c=1&etfid=EWBC.US&back=KRE
TCBI	Texas Capital Bancshares Inc.	/etf/ea/ETZCW.djhtm?c=1&etfid=TCBI.US&back=KRE
HBAN	Huntington Bancshares Incorporated	/etf/ea/ETZCW.djhtm?c=1&etfid=HBAN.US&back=KRE
RF	Regions Financial Corporation	/etf/ea/ETZCW.djhtm?c=1&etfid=RF.US&back=KRE
FRC	First Republic Bank	/etf/ea/ETZCW.djhtm?c=1&etfid=FRC.US&back=KRE
FNB	F.N.B. Corporation	/etf/ea/ETZCW.djhtm?c=1&etfid=FNB.US&back=KRE
OZK	Bank OZK	/etf/ea/ETZCW.djhtm?c=1&etfid=OZK.US&back=KRE
CMA	Comerica Incorporated	/etf/ea/ETZCW.djhtm?c=1&etfid=CMA.US&back=KRE
SNV	Synovus Financial Corp.	/etf/ea/ETZCW.djhtm?c=1&etfid=SNV.US&back=KRE
ASB	Associated Banc-Corp	/etf/ea/ETZCW.djhtm?c=1&etfid=ASB.US&back=KRE
VLY	Valley National Bancorp	/etf/ea/ETZCW.djhtm?c=1&etfid=VLY.US&back=KRE
ZION	Zions Bancorporation N.A.	/etf/ea/ETZCW.djhtm?c=1&etfid=ZION.US&back=KRE
PB	Prosperity Bancshares Inc.(R)	/etf/ea/ETZCW.djhtm?c=1&etfid=PB.US&back=KRE
WTFC	Wintrust Financial Corporation	/etf/ea/ETZCW.djhtm?c=1&etfid=WTFC.US&back=KRE
WAL	Western Alliance Bancorp	/etf/ea/ETZCW.djhtm?c=1&etfid=WAL.US&back=KRE
UMPQ	Umpqua Holdings Corporation	/etf/ea/ETZCW.djhtm?c=1&etfid=UMPQ.US&back=KRE
CADE	Cadence Bank	/etf/ea/ETZCW.djhtm?c=1&etfid=CADE.US&back=KRE
SSB	SouthState Corporation	/etf/ea/ETZCW.djhtm?c=1&etfid=SSB.US&back=KRE
FHN	First Horizon Corporation	/etf/ea/ETZCW.djhtm?c=1&etfid=FHN.US&back=KRE
WBS	Webster Financial Corporation	/etf/ea/ETZCW.djhtm?c=1&etfid=WBS.US&back=KRE
TFC	Truist Financial Corporation	/etf/ea/ETZCW.djhtm?c=1&etfid=TFC.US&back=KRE
CFG	Citizens Financial Group Inc.	/etf/ea/ETZCW.djhtm?c=1&etfid=CFG.US&back=KRE
PNC	PNC Financial Services Group Inc.	/etf/ea/ETZCW.djhtm?c=1&etfid=PNC.US&back=KRE
KEY	KeyCorp	/etf/ea/ETZCW.djhtm?c=1&etfid=KEY.US&back=KRE
BPOP	Popular Inc.	/etf/ea/ETZCW.djhtm?c=1&etfid=BPOP.US&back=KRE
BKU	BankUnited Inc.	/etf/ea/ETZCW.djhtm?c=1&etfid=BKU.US&back=KRE
FITB	Fifth Third Bancorp	/etf/ea/ETZCW.djhtm?c=1&etfid=FITB.US&back=KRE
CBSH	Commerce Bancshares Inc.	/etf/ea/ETZCW.djhtm?c=1&etfid=CBSH.US&back=KRE
COLB	Columbia Banking System Inc.	/etf/ea/ETZCW.djhtm?c=1&etfid=COLB.US&back=KRE
FIBK	First Interstate BancSystem Inc. Class A	/etf/ea/ETZCW.djhtm?c=1&etfid=FIBK.US&back=KRE
FBP	First Bancorp	/etf/ea/ETZCW.djhtm?c=1&etfid=FBP.US&back=KRE
SIVB	SVB Financial Group	/etf/ea/ETZCW.djhtm?c=1&etfid=SIVB.US&back=KRE
PACW	PacWest Bancorp	/etf/ea/ETZCW.djhtm?c=1&etfid=PACW.US&back=KRE
UBSI	United Bankshares Inc.	/etf/ea/ETZCW.djhtm?c=1&etfid=UBSI.US&back=KRE
SBNY	Signature Bank	/etf/ea/ETZCW.djhtm?c=1&etfid=SBNY.US&back=KRE
CVBF	CVB Financial Corp.	/etf/ea/ETZCW.djhtm?c=1&etfid=CVBF.US&back=KRE
ABCB	Ameris Bancorp	/etf/ea/ETZCW.djhtm?c=1&etfid=ABCB.US&back=KRE
HWC	Hancock Whitney Corporation	/etf/ea/ETZCW.djhtm?c=1&etfid=HWC.US&back=KRE
HOMB	Home BancShares Inc.	/etf/ea/ETZCW.djhtm?c=1&etfid=HOMB.US&back=KRE
UCBI	United Community Banks Inc.	/etf/ea/ETZCW.djhtm?c=1&etfid=UCBI.US&back=KRE
FULT	Fulton Financial Corporation	/etf/ea/ETZCW.djhtm?c=1&etfid=FULT.US&back=KRE
GBCI	Glacier Bancorp Inc.	/etf/ea/ETZCW.djhtm?c=1&etfid=GBCI.US&back=KRE
FFIN	First Financial Bankshares Inc	/etf/ea/ETZCW.djhtm?c=1&etfid=FFIN.US&back=KRE
SFNC	Simmons First National Corporation Class A	/etf/ea/ETZCW.djhtm?c=1&etfid=SFNC.US&back=KRE
LOB	Live Oak Bancshares Inc.	/etf/ea/ETZCW.djhtm?c=1&etfid=LOB.US&back=KRE
UMBF	UMB Financial Corporation	/etf/ea/ETZCW.djhtm?c=1&etfid=UMBF.US&back=KRE
CUBI	Customers Bancorp Inc.	/etf/ea/ETZCW.djhtm?c=1&etfid=CUBI.US&back=KRE
SFBS	ServisFirst Bancshares Inc	/etf/ea/ETZCW.djhtm?c=1&etfid=SFBS.US&back=KRE
FHB	First Hawaiian Inc.	/etf/ea/ETZCW.djhtm?c=1&etfid=FHB.US&back=KRE
BOKF	BOK Financial Corporation	/etf/ea/ETZCW.djhtm?c=1&etfid=BOKF.US&back=KRE
BOH	Bank of Hawaii Corp	/etf/ea/ETZCW.djhtm?c=1&etfid=BOH.US&back=KRE
IBTX	Independent Bank Group Inc.	/etf/ea/ETZCW.djhtm?c=1&etfid=IBTX.US&back=KRE
HTH	Hilltop Holdings Inc.	/etf/ea/ETZCW.djhtm?c=1&etfid=HTH.US&back=KRE
INDB	Independent Bank Corp.	/etf/ea/ETZCW.djhtm?c=1&etfid=INDB.US&back=KRE
PPBI	Pacific Premier Bancorp Inc.	/etf/ea/ETZCW.djhtm?c=1&etfid=PPBI.US&back=KRE
CBU	Community Bank System Inc.	/etf/ea/ETZCW.djhtm?c=1&etfid=CBU.US&back=KRE
EBC	Eastern Bankshares Inc.	/etf/ea/ETZCW.djhtm?c=1&etfid=EBC.US&back=KRE
TBK	Triumph Bancorp Inc.	/etf/ea/ETZCW.djhtm?c=1&etfid=TBK.US&back=KRE
HOPE	Hope Bancorp Inc.	/etf/ea/ETZCW.djhtm?c=1&etfid=HOPE.US&back=KRE
NWBI	Northwest Bancshares Inc.	/etf/ea/ETZCW.djhtm?c=1&etfid=NWBI.US&back=KRE
BANF	BancFirst Corporation	/etf/ea/ETZCW.djhtm?c=1&etfid=BANF.US&back=KRE
CATY	Cathay General Bancorp	/etf/ea/ETZCW.djhtm?c=1&etfid=CATY.US&back=KRE
BANR	Banner Corporation	/etf/ea/ETZCW.djhtm?c=1&etfid=BANR.US&back=KRE
WAFD	Washington Federal Inc.	/etf/ea/ETZCW.djhtm?c=1&etfid=WAFD.US&back=KRE
TBBK	Bancorp Inc	/etf/ea/ETZCW.djhtm?c=1&etfid=TBBK.US&back=KRE
LKFN	Lakeland Financial Corporation	/etf/ea/ETZCW.djhtm?c=1&etfid=LKFN.US&back=KRE
VBTX	Veritex Holdings Inc.	/etf/ea/ETZCW.djhtm?c=1&etfid=VBTX.US&back=KRE
SBCF	Seacoast Banking Corporation of Florida	/etf/ea/ETZCW.djhtm?c=1&etfid=SBCF.US&back=KRE
IBOC	International Bancshares Corporation	/etf/ea/ETZCW.djhtm?c=1&etfid=IBOC.US&back=KRE
FRME	First Merchants Corporation	/etf/ea/ETZCW.djhtm?c=1&etfid=FRME.US&back=KRE
CASH	Pathward Financial Inc.	/etf/ea/ETZCW.djhtm?c=1&etfid=CASH.US&back=KRE
BHLB	Berkshire Hills Bancorp Inc.	/etf/ea/ETZCW.djhtm?c=1&etfid=BHLB.US&back=KRE
EGBN	Eagle Bancorp Inc.	/etf/ea/ETZCW.djhtm?c=1&etfid=EGBN.US&back=KRE
TRMK	Trustmark Corporation	/etf/ea/ETZCW.djhtm?c=1&etfid=TRMK.US&back=KRE
AUB	Atlantic Union Bankshares Corporation	/etf/ea/ETZCW.djhtm?c=1&etfid=AUB.US&back=KRE
WSBC	WesBanco Inc.	/etf/ea/ETZCW.djhtm?c=1&etfid=WSBC.US&back=KRE
RNST	Renasant Corporation	/etf/ea/ETZCW.djhtm?c=1&etfid=RNST.US&back=KRE
FCF	First Commonwealth Financial Corporation	/etf/ea/ETZCW.djhtm?c=1&etfid=FCF.US&back=KRE
FFBC	First Financial Bancorp.	/etf/ea/ETZCW.djhtm?c=1&etfid=FFBC.US&back=KRE
OFG	OFG Bancorp	/etf/ea/ETZCW.djhtm?c=1&etfid=OFG.US&back=KRE
MCB	Metropolitan Bank Holding Corp.	/etf/ea/ETZCW.djhtm?c=1&etfid=MCB.US&back=KRE
FBNC	First Bancorp	/etf/ea/ETZCW.djhtm?c=1&etfid=FBNC.US&back=KRE
EFSC	Enterprise Financial Services Corp	/etf/ea/ETZCW.djhtm?c=1&etfid=EFSC.US&back=KRE
CHCO	City Holding Company	/etf/ea/ETZCW.djhtm?c=1&etfid=CHCO.US&back=KRE
HMST	HomeStreet Inc.	/etf/ea/ETZCW.djhtm?c=1&etfid=HMST.US&back=KRE
NBTB	NBT Bancorp Inc.	/etf/ea/ETZCW.djhtm?c=1&etfid=NBTB.US&back=KRE
FBK	FB Financial Corporation	/etf/ea/ETZCW.djhtm?c=1&etfid=FBK.US&back=KRE
DCOM	Dime Community Bancshares Inc.	/etf/ea/ETZCW.djhtm?c=1&etfid=DCOM.US&back=KRE
WABC	Westamerica Bancorporation	/etf/ea/ETZCW.djhtm?c=1&etfid=WABC.US&back=KRE
HTLF	Heartland Financial USA Inc.	/etf/ea/ETZCW.djhtm?c=1&etfid=HTLF.US&back=KRE
BANC	Banc of California Inc.	/etf/ea/ETZCW.djhtm?c=1&etfid=BANC.US&back=KRE
NBHC	National Bank Holdings Corporation Class A	/etf/ea/ETZCW.djhtm?c=1&etfid=NBHC.US&back=KRE
SASR	Sandy Spring Bancorp Inc.	/etf/ea/ETZCW.djhtm?c=1&etfid=SASR.US&back=KRE
TOWN	TowneBank	/etf/ea/ETZCW.djhtm?c=1&etfid=TOWN.US&back=KRE
FFWM	First Foundation Inc.	/etf/ea/ETZCW.djhtm?c=1&etfid=FFWM.US&back=KRE
STBA	S&T Bancorp Inc.	/etf/ea/ETZCW.djhtm?c=1&etfid=STBA.US&back=KRE
QCRH	QCR Holdings Inc.	/etf/ea/ETZCW.djhtm?c=1&etfid=QCRH.US&back=KRE
OCFC	OceanFirst Financial Corp.	/etf/ea/ETZCW.djhtm?c=1&etfid=OCFC.US&back=KRE
CNOB	ConnectOne Bancorp Inc.	/etf/ea/ETZCW.djhtm?c=1&etfid=CNOB.US&back=KRE
PFBC	Preferred Bank	/etf/ea/ETZCW.djhtm?c=1&etfid=PFBC.US&back=KRE
BRKL	Brookline Bancorp Inc.	/etf/ea/ETZCW.djhtm?c=1&etfid=BRKL.US&back=KRE
TCBK	TriCo Bancshares	/etf/ea/ETZCW.djhtm?c=1&etfid=TCBK.US&back=KRE
PRK	Park National Corporation	/etf/ea/ETZCW.djhtm?c=1&etfid=PRK.US&back=KRE
CPF	Central Pacific Financial Corp.	/etf/ea/ETZCW.djhtm?c=1&etfid=CPF.US&back=KRE
NIC	Nicolet Bankshares Inc.	/etf/ea/ETZCW.djhtm?c=1&etfid=NIC.US&back=KRE
HFWA	Heritage Financial Corporation	/etf/ea/ETZCW.djhtm?c=1&etfid=HFWA.US&back=KRE
HAFC	Hanmi Financial Corporation	/etf/ea/ETZCW.djhtm?c=1&etfid=HAFC.US&back=KRE
SBSI	Southside Bancshares Inc.	/etf/ea/ETZCW.djhtm?c=1&etfid=SBSI.US&back=KRE
BUSE	First Busey Corporation	/etf/ea/ETZCW.djhtm?c=1&etfid=BUSE.US&back=KRE
	STATE STREET INSTITUTIONAL LIQ STATE STR	
PFC	Premier Financial Corp.	/etf/ea/ETZCW.djhtm?c=1&etfid=PFC.US&back=KRE
	Allegiance Bancshares Inc.	
THFF	First Financial Corporation	/etf/ea/ETZCW.djhtm?c=1&etfid=THFF.US&back=KRE
AMTB	Amerant Bancorp Inc. Class A	/etf/ea/ETZCW.djhtm?c=1&etfid=AMTB.US&back=KRE
TMP	Tompkins Financial Corporation	/etf/ea/ETZCW.djhtm?c=1&etfid=TMP.US&back=KRE
HBNC	Horizon Bancorp Inc.	/etf/ea/ETZCW.djhtm?c=1&etfid=HBNC.US&back=KRE
WASH	Washington Trust Bancorp Inc.	/etf/ea/ETZCW.djhtm?c=1&etfid=WASH.US&back=KRE
LBAI	Lakeland Bancorp Inc.	/etf/ea/ETZCW.djhtm?c=1&etfid=LBAI.US&back=KRE
HONE	HarborOne Bancorp Inc	/etf/ea/ETZCW.djhtm?c=1&etfid=HONE.US&back=KRE
PEBO	Peoples Bancorp Inc.	/etf/ea/ETZCW.djhtm?c=1&etfid=PEBO.US&back=KRE
SRCE	1st Source Corporation	/etf/ea/ETZCW.djhtm?c=1&etfid=SRCE.US&back=KRE
BY	Byline Bancorp Inc.	/etf/ea/ETZCW.djhtm?c=1&etfid=BY.US&back=KRE
OSBC	Old Second Bancorp Inc.	/etf/ea/ETZCW.djhtm?c=1&etfid=OSBC.US&back=KRE
	CBTX Inc.	
GSBC	Great Southern Bancorp Inc.	/etf/ea/ETZCW.djhtm?c=1&etfid=GSBC.US&back=KRE
FFIC	Flushing Financial Corporation	/etf/ea/ETZCW.djhtm?c=1&etfid=FFIC.US&back=KRE
FBMS	First Bancshares Inc.	/etf/ea/ETZCW.djhtm?c=1&etfid=FBMS.US&back=KRE
UVSP	Univest Financial Corporation	/etf/ea/ETZCW.djhtm?c=1&etfid=UVSP.US&back=KRE
CTBI	Community Trust Bancorp Inc.	/etf/ea/ETZCW.djhtm?c=1&etfid=CTBI.US&back=KRE
OBNK	Origin Bancorp Inc.	/etf/ea/ETZCW.djhtm?c=1&etfid=OBNK.US&back=KRE
PGC	Peapack-Gladstone Financial Corporation	/etf/ea/ETZCW.djhtm?c=1&etfid=PGC.US&back=KRE
MSBI	Midland States Bancorp Inc.	/etf/ea/ETZCW.djhtm?c=1&etfid=MSBI.US&back=KRE
HTBK	Heritage Commerce Corp	/etf/ea/ETZCW.djhtm?c=1&etfid=HTBK.US&back=KRE
CAC	Camden National Corporation	/etf/ea/ETZCW.djhtm?c=1&etfid=CAC.US&back=KRE
IBCP	Independent Bank Corporation	/etf/ea/ETZCW.djhtm?c=1&etfid=IBCP.US&back=KRE
BMRC	Bank of Marin Bancorp	/etf/ea/ETZCW.djhtm?c=1&etfid=BMRC.US&back=KRE
MBWM	Mercantile Bank Corporation	/etf/ea/ETZCW.djhtm?c=1&etfid=MBWM.US&back=KRE
CFB	CrossFirst Bankshares Inc.	/etf/ea/ETZCW.djhtm?c=1&etfid=CFB.US&back=KRE
FISI	Financial Institutions Inc.	/etf/ea/ETZCW.djhtm?c=1&etfid=FISI.US&back=KRE
