MDY
TRGP	Targa Resources Corp.	/etf/ea/ETZCW.djhtm?c=1&etfid=TRGP.US&back=MDY
CSL	Carlisle Companies Incorporated	/etf/ea/ETZCW.djhtm?c=1&etfid=CSL.US&back=MDY
STLD	Steel Dynamics Inc.	/etf/ea/ETZCW.djhtm?c=1&etfid=STLD.US&back=MDY
EQT	EQT Corporation	/etf/ea/ETZCW.djhtm?c=1&etfid=EQT.US&back=MDY
WOLF	Wolfspeed Inc	/etf/ea/ETZCW.djhtm?c=1&etfid=WOLF.US&back=MDY
FSLR	First Solar Inc.	/etf/ea/ETZCW.djhtm?c=1&etfid=FSLR.US&back=MDY
DAR	Darling Ingredients Inc.	/etf/ea/ETZCW.djhtm?c=1&etfid=DAR.US&back=MDY
	U.S. Dollar	
FHN	First Horizon Corporation	/etf/ea/ETZCW.djhtm?c=1&etfid=FHN.US&back=MDY
RPM	RPM International Inc.	/etf/ea/ETZCW.djhtm?c=1&etfid=RPM.US&back=MDY
FICO	Fair Isaac Corporation	/etf/ea/ETZCW.djhtm?c=1&etfid=FICO.US&back=MDY
RS	Reliance Steel & Aluminum Co.	/etf/ea/ETZCW.djhtm?c=1&etfid=RS.US&back=MDY
Y	Alleghany Corporation	/etf/ea/ETZCW.djhtm?c=1&etfid=Y.US&back=MDY
WTRG	Essential Utilities Inc.	/etf/ea/ETZCW.djhtm?c=1&etfid=WTRG.US&back=MDY
RGEN	Repligen Corporation	/etf/ea/ETZCW.djhtm?c=1&etfid=RGEN.US&back=MDY
HUBB	Hubbell Incorporated	/etf/ea/ETZCW.djhtm?c=1&etfid=HUBB.US&back=MDY
GGG	Graco Inc.	/etf/ea/ETZCW.djhtm?c=1&etfid=GGG.US&back=MDY
LSI	Life Storage Inc.	/etf/ea/ETZCW.djhtm?c=1&etfid=LSI.US&back=MDY
SWAV	Shockwave Medical Inc.	/etf/ea/ETZCW.djhtm?c=1&etfid=SWAV.US&back=MDY
WSM	Williams-Sonoma Inc.	/etf/ea/ETZCW.djhtm?c=1&etfid=WSM.US&back=MDY
ACM	AECOM	/etf/ea/ETZCW.djhtm?c=1&etfid=ACM.US&back=MDY
REXR	Rexford Industrial Realty Inc.	/etf/ea/ETZCW.djhtm?c=1&etfid=REXR.US&back=MDY
UTHR	United Therapeutics Corporation	/etf/ea/ETZCW.djhtm?c=1&etfid=UTHR.US&back=MDY
EWBC	East West Bancorp Inc.	/etf/ea/ETZCW.djhtm?c=1&etfid=EWBC.US&back=MDY
BLDR	Builders FirstSource Inc.	/etf/ea/ETZCW.djhtm?c=1&etfid=BLDR.US&back=MDY
BJ	BJ's Wholesale Club Holdings Inc.	/etf/ea/ETZCW.djhtm?c=1&etfid=BJ.US&back=MDY
NBIX	Neurocrine Biosciences Inc.	/etf/ea/ETZCW.djhtm?c=1&etfid=NBIX.US&back=MDY
SCI	Service Corporation International	/etf/ea/ETZCW.djhtm?c=1&etfid=SCI.US&back=MDY
JAZZ	Jazz Pharmaceuticals Public Limited Company	/etf/ea/ETZCW.djhtm?c=1&etfid=JAZZ.US&back=MDY
PCTY	Paylocity Holding Corp.	/etf/ea/ETZCW.djhtm?c=1&etfid=PCTY.US&back=MDY
HR	Healthcare Realty Trust Incorporated Class A	/etf/ea/ETZCW.djhtm?c=1&etfid=HR.US&back=MDY
RRX	Regal Rexnord Corporation	/etf/ea/ETZCW.djhtm?c=1&etfid=RRX.US&back=MDY
AA	Alcoa Corporation	/etf/ea/ETZCW.djhtm?c=1&etfid=AA.US&back=MDY
WSO	Watsco Inc.	/etf/ea/ETZCW.djhtm?c=1&etfid=WSO.US&back=MDY
MANH	Manhattan Associates Inc.	/etf/ea/ETZCW.djhtm?c=1&etfid=MANH.US&back=MDY
MPW	Medical Properties Trust Inc.	/etf/ea/ETZCW.djhtm?c=1&etfid=MPW.US&back=MDY
DECK	Deckers Outdoor Corporation	/etf/ea/ETZCW.djhtm?c=1&etfid=DECK.US&back=MDY
TTC	Toro Company	/etf/ea/ETZCW.djhtm?c=1&etfid=TTC.US&back=MDY
RRC	Range Resources Corporation	/etf/ea/ETZCW.djhtm?c=1&etfid=RRC.US&back=MDY
JBL	Jabil Inc.	/etf/ea/ETZCW.djhtm?c=1&etfid=JBL.US&back=MDY
AFG	American Financial Group Inc.	/etf/ea/ETZCW.djhtm?c=1&etfid=AFG.US&back=MDY
JLL	Jones Lang LaSalle Incorporated	/etf/ea/ETZCW.djhtm?c=1&etfid=JLL.US&back=MDY
RGA	Reinsurance Group of America Incorporated	/etf/ea/ETZCW.djhtm?c=1&etfid=RGA.US&back=MDY
WBS	Webster Financial Corporation	/etf/ea/ETZCW.djhtm?c=1&etfid=WBS.US&back=MDY
SWN	Southwestern Energy Company	/etf/ea/ETZCW.djhtm?c=1&etfid=SWN.US&back=MDY
UGI	UGI Corporation	/etf/ea/ETZCW.djhtm?c=1&etfid=UGI.US&back=MDY
LEA	Lear Corporation	/etf/ea/ETZCW.djhtm?c=1&etfid=LEA.US&back=MDY
AXON	Axon Enterprise Inc	/etf/ea/ETZCW.djhtm?c=1&etfid=AXON.US&back=MDY
KNX	Knight-Swift Transportation Holdings Inc. Class A	/etf/ea/ETZCW.djhtm?c=1&etfid=KNX.US&back=MDY
CLF	Cleveland-Cliffs Inc	/etf/ea/ETZCW.djhtm?c=1&etfid=CLF.US&back=MDY
LAMR	Lamar Advertising Company Class A	/etf/ea/ETZCW.djhtm?c=1&etfid=LAMR.US&back=MDY
OGE	OGE Energy Corp.	/etf/ea/ETZCW.djhtm?c=1&etfid=OGE.US&back=MDY
G	Genpact Limited	/etf/ea/ETZCW.djhtm?c=1&etfid=G.US&back=MDY
LECO	Lincoln Electric Holdings Inc.	/etf/ea/ETZCW.djhtm?c=1&etfid=LECO.US&back=MDY
OC	Owens Corning	/etf/ea/ETZCW.djhtm?c=1&etfid=OC.US&back=MDY
CASY	Casey's General Stores Inc.	/etf/ea/ETZCW.djhtm?c=1&etfid=CASY.US&back=MDY
LII	Lennox International Inc.	/etf/ea/ETZCW.djhtm?c=1&etfid=LII.US&back=MDY
NNN	National Retail Properties Inc.	/etf/ea/ETZCW.djhtm?c=1&etfid=NNN.US&back=MDY
DINO	HF Sinclair Corporation	/etf/ea/ETZCW.djhtm?c=1&etfid=DINO.US&back=MDY
MIDD	Middleby Corporation	/etf/ea/ETZCW.djhtm?c=1&etfid=MIDD.US&back=MDY
MAT	Mattel Inc.	/etf/ea/ETZCW.djhtm?c=1&etfid=MAT.US&back=MDY
PFGC	Performance Food Group Company	/etf/ea/ETZCW.djhtm?c=1&etfid=PFGC.US&back=MDY
CIEN	Ciena Corporation	/etf/ea/ETZCW.djhtm?c=1&etfid=CIEN.US&back=MDY
OHI	Omega Healthcare Investors Inc.	/etf/ea/ETZCW.djhtm?c=1&etfid=OHI.US&back=MDY
LAD	Lithia Motors Inc.	/etf/ea/ETZCW.djhtm?c=1&etfid=LAD.US&back=MDY
UNM	Unum Group	/etf/ea/ETZCW.djhtm?c=1&etfid=UNM.US&back=MDY
OLN	Olin Corporation	/etf/ea/ETZCW.djhtm?c=1&etfid=OLN.US&back=MDY
CBSH	Commerce Bancshares Inc.	/etf/ea/ETZCW.djhtm?c=1&etfid=CBSH.US&back=MDY
MASI	Masimo Corporation	/etf/ea/ETZCW.djhtm?c=1&etfid=MASI.US&back=MDY
LSCC	Lattice Semiconductor Corporation	/etf/ea/ETZCW.djhtm?c=1&etfid=LSCC.US&back=MDY
ACHC	Acadia Healthcare Company Inc.	/etf/ea/ETZCW.djhtm?c=1&etfid=ACHC.US&back=MDY
CFR	Cullen/Frost Bankers Inc.	/etf/ea/ETZCW.djhtm?c=1&etfid=CFR.US&back=MDY
CGNX	Cognex Corporation	/etf/ea/ETZCW.djhtm?c=1&etfid=CGNX.US&back=MDY
TTEK	Tetra Tech Inc.	/etf/ea/ETZCW.djhtm?c=1&etfid=TTEK.US&back=MDY
HRB	H&R Block Inc.	/etf/ea/ETZCW.djhtm?c=1&etfid=HRB.US&back=MDY
CHE	Chemed Corporation	/etf/ea/ETZCW.djhtm?c=1&etfid=CHE.US&back=MDY
FIVE	Five Below Inc.	/etf/ea/ETZCW.djhtm?c=1&etfid=FIVE.US&back=MDY
GME	GameStop Corp. Class A	/etf/ea/ETZCW.djhtm?c=1&etfid=GME.US&back=MDY
CPRI	Capri Holdings Limited	/etf/ea/ETZCW.djhtm?c=1&etfid=CPRI.US&back=MDY
GTLS	Chart Industries Inc.	/etf/ea/ETZCW.djhtm?c=1&etfid=GTLS.US&back=MDY
NOV	NOV Inc.	/etf/ea/ETZCW.djhtm?c=1&etfid=NOV.US&back=MDY
RUN	Sunrun Inc.	/etf/ea/ETZCW.djhtm?c=1&etfid=RUN.US&back=MDY
WEX	WEX Inc.	/etf/ea/ETZCW.djhtm?c=1&etfid=WEX.US&back=MDY
ARW	Arrow Electronics Inc.	/etf/ea/ETZCW.djhtm?c=1&etfid=ARW.US&back=MDY
EGP	EastGroup Properties Inc.	/etf/ea/ETZCW.djhtm?c=1&etfid=EGP.US&back=MDY
STOR	STORE Capital Corporation	/etf/ea/ETZCW.djhtm?c=1&etfid=STOR.US&back=MDY
CHDN	Churchill Downs Incorporated	/etf/ea/ETZCW.djhtm?c=1&etfid=CHDN.US&back=MDY
ATR	Aptargroup Inc.	/etf/ea/ETZCW.djhtm?c=1&etfid=ATR.US&back=MDY
KBR	KBR Inc.	/etf/ea/ETZCW.djhtm?c=1&etfid=KBR.US&back=MDY
FR	First Industrial Realty Trust Inc.	/etf/ea/ETZCW.djhtm?c=1&etfid=FR.US&back=MDY
AGCO	AGCO Corporation	/etf/ea/ETZCW.djhtm?c=1&etfid=AGCO.US&back=MDY
MTDR	Matador Resources Company	/etf/ea/ETZCW.djhtm?c=1&etfid=MTDR.US&back=MDY
CACI	CACI International Inc Class A	/etf/ea/ETZCW.djhtm?c=1&etfid=CACI.US&back=MDY
PB	Prosperity Bancshares Inc.(R)	/etf/ea/ETZCW.djhtm?c=1&etfid=PB.US&back=MDY
NFG	National Fuel Gas Company	/etf/ea/ETZCW.djhtm?c=1&etfid=NFG.US&back=MDY
PDCE	PDC Energy Inc.	/etf/ea/ETZCW.djhtm?c=1&etfid=PDCE.US&back=MDY
MUSA	Murphy USA Inc.	/etf/ea/ETZCW.djhtm?c=1&etfid=MUSA.US&back=MDY
BRX	Brixmor Property Group Inc.	/etf/ea/ETZCW.djhtm?c=1&etfid=BRX.US&back=MDY
AIRC	Apartment Income REIT Corp	/etf/ea/ETZCW.djhtm?c=1&etfid=AIRC.US&back=MDY
GNTX	Gentex Corporation	/etf/ea/ETZCW.djhtm?c=1&etfid=GNTX.US&back=MDY
DCI	Donaldson Company Inc.	/etf/ea/ETZCW.djhtm?c=1&etfid=DCI.US&back=MDY
PII	Polaris Inc.	/etf/ea/ETZCW.djhtm?c=1&etfid=PII.US&back=MDY
SF	Stifel Financial Corp.	/etf/ea/ETZCW.djhtm?c=1&etfid=SF.US&back=MDY
VOYA	Voya Financial Inc.	/etf/ea/ETZCW.djhtm?c=1&etfid=VOYA.US&back=MDY
ORI	Old Republic International Corporation	/etf/ea/ETZCW.djhtm?c=1&etfid=ORI.US&back=MDY
DKS	Dick's Sporting Goods Inc.	/etf/ea/ETZCW.djhtm?c=1&etfid=DKS.US&back=MDY
SYNH	Syneos Health Inc. Class A	/etf/ea/ETZCW.djhtm?c=1&etfid=SYNH.US&back=MDY
PNFP	Pinnacle Financial Partners Inc.	/etf/ea/ETZCW.djhtm?c=1&etfid=PNFP.US&back=MDY
JEF	Jefferies Financial Group Inc.	/etf/ea/ETZCW.djhtm?c=1&etfid=JEF.US&back=MDY
SON	Sonoco Products Company	/etf/ea/ETZCW.djhtm?c=1&etfid=SON.US&back=MDY
MDU	MDU Resources Group Inc	/etf/ea/ETZCW.djhtm?c=1&etfid=MDU.US&back=MDY
	II-VI Incorporated	
THC	Tenet Healthcare Corporation	/etf/ea/ETZCW.djhtm?c=1&etfid=THC.US&back=MDY
EME	EMCOR Group Inc.	/etf/ea/ETZCW.djhtm?c=1&etfid=EME.US&back=MDY
ITT	ITT Inc.	/etf/ea/ETZCW.djhtm?c=1&etfid=ITT.US&back=MDY
TXRH	Texas Roadhouse Inc.	/etf/ea/ETZCW.djhtm?c=1&etfid=TXRH.US&back=MDY
RGLD	Royal Gold Inc.	/etf/ea/ETZCW.djhtm?c=1&etfid=RGLD.US&back=MDY
NVST	Envista Holdings Corp.	/etf/ea/ETZCW.djhtm?c=1&etfid=NVST.US&back=MDY
BLD	TopBuild Corp.	/etf/ea/ETZCW.djhtm?c=1&etfid=BLD.US&back=MDY
WH	Wyndham Hotels & Resorts Inc.	/etf/ea/ETZCW.djhtm?c=1&etfid=WH.US&back=MDY
RNR	RenaissanceRe Holdings Ltd.	/etf/ea/ETZCW.djhtm?c=1&etfid=RNR.US&back=MDY
X	United States Steel Corporation	/etf/ea/ETZCW.djhtm?c=1&etfid=X.US&back=MDY
VAC	Marriott Vacations Worldwide Corporation	/etf/ea/ETZCW.djhtm?c=1&etfid=VAC.US&back=MDY
VMI	Valmont Industries Inc.	/etf/ea/ETZCW.djhtm?c=1&etfid=VMI.US&back=MDY
AZPN	Aspen Technology Inc.	/etf/ea/ETZCW.djhtm?c=1&etfid=AZPN.US&back=MDY
CLH	Clean Harbors Inc.	/etf/ea/ETZCW.djhtm?c=1&etfid=CLH.US&back=MDY
LFUS	Littelfuse Inc.	/etf/ea/ETZCW.djhtm?c=1&etfid=LFUS.US&back=MDY
SNV	Synovus Financial Corp.	/etf/ea/ETZCW.djhtm?c=1&etfid=SNV.US&back=MDY
PEN	Penumbra Inc.	/etf/ea/ETZCW.djhtm?c=1&etfid=PEN.US&back=MDY
INGR	Ingredion Incorporated	/etf/ea/ETZCW.djhtm?c=1&etfid=INGR.US&back=MDY
LITE	Lumentum Holdings Inc.	/etf/ea/ETZCW.djhtm?c=1&etfid=LITE.US&back=MDY
FAF	First American Financial Corporation	/etf/ea/ETZCW.djhtm?c=1&etfid=FAF.US&back=MDY
CAR	Avis Budget Group Inc.	/etf/ea/ETZCW.djhtm?c=1&etfid=CAR.US&back=MDY
WU	Western Union Company	/etf/ea/ETZCW.djhtm?c=1&etfid=WU.US&back=MDY
SEIC	SEI Investments Company	/etf/ea/ETZCW.djhtm?c=1&etfid=SEIC.US&back=MDY
MUR	Murphy Oil Corporation	/etf/ea/ETZCW.djhtm?c=1&etfid=MUR.US&back=MDY
EXEL	Exelixis Inc.	/etf/ea/ETZCW.djhtm?c=1&etfid=EXEL.US&back=MDY
MKSI	MKS Instruments Inc.	/etf/ea/ETZCW.djhtm?c=1&etfid=MKSI.US&back=MDY
HOG	Harley-Davidson Inc.	/etf/ea/ETZCW.djhtm?c=1&etfid=HOG.US&back=MDY
IRDM	Iridium Communications Inc.	/etf/ea/ETZCW.djhtm?c=1&etfid=IRDM.US&back=MDY
AYI	Acuity Brands Inc.	/etf/ea/ETZCW.djhtm?c=1&etfid=AYI.US&back=MDY
CW	Curtiss-Wright Corporation	/etf/ea/ETZCW.djhtm?c=1&etfid=CW.US&back=MDY
BC	Brunswick Corporation	/etf/ea/ETZCW.djhtm?c=1&etfid=BC.US&back=MDY
WWD	Woodward Inc.	/etf/ea/ETZCW.djhtm?c=1&etfid=WWD.US&back=MDY
HALO	Halozyme Therapeutics Inc.	/etf/ea/ETZCW.djhtm?c=1&etfid=HALO.US&back=MDY
BRKR	Bruker Corporation	/etf/ea/ETZCW.djhtm?c=1&etfid=BRKR.US&back=MDY
CABO	Cable One Inc.	/etf/ea/ETZCW.djhtm?c=1&etfid=CABO.US&back=MDY
HQY	HealthEquity Inc	/etf/ea/ETZCW.djhtm?c=1&etfid=HQY.US&back=MDY
FCN	FTI Consulting Inc.	/etf/ea/ETZCW.djhtm?c=1&etfid=FCN.US&back=MDY
IDA	IDACORP Inc.	/etf/ea/ETZCW.djhtm?c=1&etfid=IDA.US&back=MDY
GBCI	Glacier Bancorp Inc.	/etf/ea/ETZCW.djhtm?c=1&etfid=GBCI.US&back=MDY
SRC	Spirit Realty Capital Inc.	/etf/ea/ETZCW.djhtm?c=1&etfid=SRC.US&back=MDY
NVT	nVent Electric plc	/etf/ea/ETZCW.djhtm?c=1&etfid=NVT.US&back=MDY
SAIA	Saia Inc.	/etf/ea/ETZCW.djhtm?c=1&etfid=SAIA.US&back=MDY
KNSL	Kinsale Capital Group Inc.	/etf/ea/ETZCW.djhtm?c=1&etfid=KNSL.US&back=MDY
FFIN	First Financial Bankshares Inc	/etf/ea/ETZCW.djhtm?c=1&etfid=FFIN.US&back=MDY
LSTR	Landstar System Inc.	/etf/ea/ETZCW.djhtm?c=1&etfid=LSTR.US&back=MDY
FLO	Flowers Foods Inc.	/etf/ea/ETZCW.djhtm?c=1&etfid=FLO.US&back=MDY
CNXC	Concentrix Corporation	/etf/ea/ETZCW.djhtm?c=1&etfid=CNXC.US&back=MDY
IBKR	Interactive Brokers Group Inc. Class A	/etf/ea/ETZCW.djhtm?c=1&etfid=IBKR.US&back=MDY
DTM	DT Midstream Inc.	/etf/ea/ETZCW.djhtm?c=1&etfid=DTM.US&back=MDY
TREX	Trex Company Inc.	/etf/ea/ETZCW.djhtm?c=1&etfid=TREX.US&back=MDY
OSK	Oshkosh Corp	/etf/ea/ETZCW.djhtm?c=1&etfid=OSK.US&back=MDY
CC	Chemours Co.	/etf/ea/ETZCW.djhtm?c=1&etfid=CC.US&back=MDY
NATI	National Instruments Corporation	/etf/ea/ETZCW.djhtm?c=1&etfid=NATI.US&back=MDY
SWX	Southwest Gas Holdings Inc.	/etf/ea/ETZCW.djhtm?c=1&etfid=SWX.US&back=MDY
RYN	Rayonier Inc.	/etf/ea/ETZCW.djhtm?c=1&etfid=RYN.US&back=MDY
XPO	XPO Logistics Inc.	/etf/ea/ETZCW.djhtm?c=1&etfid=XPO.US&back=MDY
VVV	Valvoline Inc.	/etf/ea/ETZCW.djhtm?c=1&etfid=VVV.US&back=MDY
ASH	Ashland Inc.	/etf/ea/ETZCW.djhtm?c=1&etfid=ASH.US&back=MDY
KRC	Kilroy Realty Corporation	/etf/ea/ETZCW.djhtm?c=1&etfid=KRC.US&back=MDY
LEG	Leggett & Platt Incorporated	/etf/ea/ETZCW.djhtm?c=1&etfid=LEG.US&back=MDY
SKX	Skechers U.S.A. Inc. Class A	/etf/ea/ETZCW.djhtm?c=1&etfid=SKX.US&back=MDY
SAIC	Science Applications International Corp.	/etf/ea/ETZCW.djhtm?c=1&etfid=SAIC.US&back=MDY
WTFC	Wintrust Financial Corporation	/etf/ea/ETZCW.djhtm?c=1&etfid=WTFC.US&back=MDY
NYT	New York Times Company Class A	/etf/ea/ETZCW.djhtm?c=1&etfid=NYT.US&back=MDY
QLYS	Qualys Inc.	/etf/ea/ETZCW.djhtm?c=1&etfid=QLYS.US&back=MDY
UBSI	United Bankshares Inc.	/etf/ea/ETZCW.djhtm?c=1&etfid=UBSI.US&back=MDY
PRGO	Perrigo Co. Plc	/etf/ea/ETZCW.djhtm?c=1&etfid=PRGO.US&back=MDY
LHCG	LHC Group Inc.	/etf/ea/ETZCW.djhtm?c=1&etfid=LHCG.US&back=MDY
IAA	IAA Inc.	/etf/ea/ETZCW.djhtm?c=1&etfid=IAA.US&back=MDY
POST	Post Holdings Inc.	/etf/ea/ETZCW.djhtm?c=1&etfid=POST.US&back=MDY
ASGN	ASGN Inc	/etf/ea/ETZCW.djhtm?c=1&etfid=ASGN.US&back=MDY
M	Macy's Inc	/etf/ea/ETZCW.djhtm?c=1&etfid=M.US&back=MDY
HXL	Hexcel Corporation	/etf/ea/ETZCW.djhtm?c=1&etfid=HXL.US&back=MDY
AMG	Affiliated Managers Group Inc.	/etf/ea/ETZCW.djhtm?c=1&etfid=AMG.US&back=MDY
CMC	Commercial Metals Company	/etf/ea/ETZCW.djhtm?c=1&etfid=CMC.US&back=MDY
BKH	Black Hills Corporation	/etf/ea/ETZCW.djhtm?c=1&etfid=BKH.US&back=MDY
ONB	Old National Bancorp	/etf/ea/ETZCW.djhtm?c=1&etfid=ONB.US&back=MDY
VLY	Valley National Bancorp	/etf/ea/ETZCW.djhtm?c=1&etfid=VLY.US&back=MDY
PRI	Primerica Inc.	/etf/ea/ETZCW.djhtm?c=1&etfid=PRI.US&back=MDY
OLED	Universal Display Corporation	/etf/ea/ETZCW.djhtm?c=1&etfid=OLED.US&back=MDY
EHC	Encompass Health Corporation	/etf/ea/ETZCW.djhtm?c=1&etfid=EHC.US&back=MDY
TOL	Toll Brothers Inc.	/etf/ea/ETZCW.djhtm?c=1&etfid=TOL.US&back=MDY
SIGI	Selective Insurance Group Inc.	/etf/ea/ETZCW.djhtm?c=1&etfid=SIGI.US&back=MDY
NOVT	Novanta Inc	/etf/ea/ETZCW.djhtm?c=1&etfid=NOVT.US&back=MDY
TGNA	TEGNA Inc.	/etf/ea/ETZCW.djhtm?c=1&etfid=TGNA.US&back=MDY
EXP	Eagle Materials Inc.	/etf/ea/ETZCW.djhtm?c=1&etfid=EXP.US&back=MDY
LNW	Light & Wonder Inc.	/etf/ea/ETZCW.djhtm?c=1&etfid=LNW.US&back=MDY
GMED	Globus Medical Inc Class A	/etf/ea/ETZCW.djhtm?c=1&etfid=GMED.US&back=MDY
CADE	Cadence Bank	/etf/ea/ETZCW.djhtm?c=1&etfid=CADE.US&back=MDY
OPCH	Option Care Health Inc	/etf/ea/ETZCW.djhtm?c=1&etfid=OPCH.US&back=MDY
SRCL	Stericycle Inc.	/etf/ea/ETZCW.djhtm?c=1&etfid=SRCL.US&back=MDY
POR	Portland General Electric Company	/etf/ea/ETZCW.djhtm?c=1&etfid=POR.US&back=MDY
THG	Hanover Insurance Group Inc.	/etf/ea/ETZCW.djhtm?c=1&etfid=THG.US&back=MDY
MTZ	MasTec Inc.	/etf/ea/ETZCW.djhtm?c=1&etfid=MTZ.US&back=MDY
SLAB	Silicon Laboratories Inc.	/etf/ea/ETZCW.djhtm?c=1&etfid=SLAB.US&back=MDY
SYNA	Synaptics Incorporated	/etf/ea/ETZCW.djhtm?c=1&etfid=SYNA.US&back=MDY
OZK	Bank OZK	/etf/ea/ETZCW.djhtm?c=1&etfid=OZK.US&back=MDY
NYCB	New York Community Bancorp Inc.	/etf/ea/ETZCW.djhtm?c=1&etfid=NYCB.US&back=MDY
CROX	Crocs Inc.	/etf/ea/ETZCW.djhtm?c=1&etfid=CROX.US&back=MDY
STAA	STAAR Surgical Company	/etf/ea/ETZCW.djhtm?c=1&etfid=STAA.US&back=MDY
OMCL	Omnicell Inc.	/etf/ea/ETZCW.djhtm?c=1&etfid=OMCL.US&back=MDY
GXO	GXO Logistics Inc	/etf/ea/ETZCW.djhtm?c=1&etfid=GXO.US&back=MDY
RH	RH	/etf/ea/ETZCW.djhtm?c=1&etfid=RH.US&back=MDY
CR	Crane Holdings Co.	/etf/ea/ETZCW.djhtm?c=1&etfid=CR.US&back=MDY
EEFT	Euronet Worldwide Inc.	/etf/ea/ETZCW.djhtm?c=1&etfid=EEFT.US&back=MDY
THO	Thor Industries Inc.	/etf/ea/ETZCW.djhtm?c=1&etfid=THO.US&back=MDY
LPX	Louisiana-Pacific Corporation	/etf/ea/ETZCW.djhtm?c=1&etfid=LPX.US&back=MDY
HOMB	Home BancShares Inc.	/etf/ea/ETZCW.djhtm?c=1&etfid=HOMB.US&back=MDY
CHX	ChampionX Corporation	/etf/ea/ETZCW.djhtm?c=1&etfid=CHX.US&back=MDY
AN	AutoNation Inc.	/etf/ea/ETZCW.djhtm?c=1&etfid=AN.US&back=MDY
MTG	MGIC Investment Corporation	/etf/ea/ETZCW.djhtm?c=1&etfid=MTG.US&back=MDY
CRUS	Cirrus Logic Inc.	/etf/ea/ETZCW.djhtm?c=1&etfid=CRUS.US&back=MDY
TPX	Tempur Sealy International Inc	/etf/ea/ETZCW.djhtm?c=1&etfid=TPX.US&back=MDY
RLI	RLI Corp.	/etf/ea/ETZCW.djhtm?c=1&etfid=RLI.US&back=MDY
BYD	Boyd Gaming Corporation	/etf/ea/ETZCW.djhtm?c=1&etfid=BYD.US&back=MDY
MSA	MSA Safety Inc.	/etf/ea/ETZCW.djhtm?c=1&etfid=MSA.US&back=MDY
ESNT	Essent Group Ltd.	/etf/ea/ETZCW.djhtm?c=1&etfid=ESNT.US&back=MDY
IRT	Independence Realty Trust Inc.	/etf/ea/ETZCW.djhtm?c=1&etfid=IRT.US&back=MDY
AVT	Avnet Inc.	/etf/ea/ETZCW.djhtm?c=1&etfid=AVT.US&back=MDY
HE	Hawaiian Electric Industries Inc.	/etf/ea/ETZCW.djhtm?c=1&etfid=HE.US&back=MDY
UNVR	Univar Solutions Inc.	/etf/ea/ETZCW.djhtm?c=1&etfid=UNVR.US&back=MDY
NSA	National Storage Affiliates Trust	/etf/ea/ETZCW.djhtm?c=1&etfid=NSA.US&back=MDY
TKR	Timken Company	/etf/ea/ETZCW.djhtm?c=1&etfid=TKR.US&back=MDY
NJR	New Jersey Resources Corporation	/etf/ea/ETZCW.djhtm?c=1&etfid=NJR.US&back=MDY
NCR	NCR Corporation	/etf/ea/ETZCW.djhtm?c=1&etfid=NCR.US&back=MDY
KRG	Kite Realty Group Trust	/etf/ea/ETZCW.djhtm?c=1&etfid=KRG.US&back=MDY
OGS	ONE Gas Inc.	/etf/ea/ETZCW.djhtm?c=1&etfid=OGS.US&back=MDY
ARWR	Arrowhead Pharmaceuticals Inc.	/etf/ea/ETZCW.djhtm?c=1&etfid=ARWR.US&back=MDY
ORA	Ormat Technologies Inc.	/etf/ea/ETZCW.djhtm?c=1&etfid=ORA.US&back=MDY
POWI	Power Integrations Inc.	/etf/ea/ETZCW.djhtm?c=1&etfid=POWI.US&back=MDY
HWC	Hancock Whitney Corporation	/etf/ea/ETZCW.djhtm?c=1&etfid=HWC.US&back=MDY
SLM	SLM Corp	/etf/ea/ETZCW.djhtm?c=1&etfid=SLM.US&back=MDY
PNM	PNM Resources Inc.	/etf/ea/ETZCW.djhtm?c=1&etfid=PNM.US&back=MDY
CBT	Cabot Corporation	/etf/ea/ETZCW.djhtm?c=1&etfid=CBT.US&back=MDY
KEX	Kirby Corporation	/etf/ea/ETZCW.djhtm?c=1&etfid=KEX.US&back=MDY
FNB	F.N.B. Corporation	/etf/ea/ETZCW.djhtm?c=1&etfid=FNB.US&back=MDY
AVNT	Avient Corporation	/etf/ea/ETZCW.djhtm?c=1&etfid=AVNT.US&back=MDY
SSD	Simpson Manufacturing Co. Inc.	/etf/ea/ETZCW.djhtm?c=1&etfid=SSD.US&back=MDY
CUZ	Cousins Properties Incorporated	/etf/ea/ETZCW.djhtm?c=1&etfid=CUZ.US&back=MDY
FLS	Flowserve Corporation	/etf/ea/ETZCW.djhtm?c=1&etfid=FLS.US&back=MDY
SNX	TD SYNNEX Corporation	/etf/ea/ETZCW.djhtm?c=1&etfid=SNX.US&back=MDY
CELH	Celsius Holdings Inc.	/etf/ea/ETZCW.djhtm?c=1&etfid=CELH.US&back=MDY
MEDP	Medpace Holdings Inc.	/etf/ea/ETZCW.djhtm?c=1&etfid=MEDP.US&back=MDY
QDEL	QuidelOrtho Corporation	/etf/ea/ETZCW.djhtm?c=1&etfid=QDEL.US&back=MDY
GT	Goodyear Tire & Rubber Company	/etf/ea/ETZCW.djhtm?c=1&etfid=GT.US&back=MDY
AZTA	Azenta Inc.	/etf/ea/ETZCW.djhtm?c=1&etfid=AZTA.US&back=MDY
FOXF	Fox Factory Holding Corp.	/etf/ea/ETZCW.djhtm?c=1&etfid=FOXF.US&back=MDY
JHG	Janus Henderson Group PLC	/etf/ea/ETZCW.djhtm?c=1&etfid=JHG.US&back=MDY
R	Ryder System Inc.	/etf/ea/ETZCW.djhtm?c=1&etfid=R.US&back=MDY
NSP	Insperity Inc.	/etf/ea/ETZCW.djhtm?c=1&etfid=NSP.US&back=MDY
MAN	ManpowerGroup Inc.	/etf/ea/ETZCW.djhtm?c=1&etfid=MAN.US&back=MDY
AMED	Amedisys Inc.	/etf/ea/ETZCW.djhtm?c=1&etfid=AMED.US&back=MDY
UMBF	UMB Financial Corporation	/etf/ea/ETZCW.djhtm?c=1&etfid=UMBF.US&back=MDY
UMPQ	Umpqua Holdings Corporation	/etf/ea/ETZCW.djhtm?c=1&etfid=UMPQ.US&back=MDY
SLGN	Silgan Holdings Inc.	/etf/ea/ETZCW.djhtm?c=1&etfid=SLGN.US&back=MDY
HAE	Haemonetics Corporation	/etf/ea/ETZCW.djhtm?c=1&etfid=HAE.US&back=MDY
EVR	Evercore Inc. Class A	/etf/ea/ETZCW.djhtm?c=1&etfid=EVR.US&back=MDY
WTS	Watts Water Technologies Inc. Class A	/etf/ea/ETZCW.djhtm?c=1&etfid=WTS.US&back=MDY
CHH	Choice Hotels International Inc.	/etf/ea/ETZCW.djhtm?c=1&etfid=CHH.US&back=MDY
ETRN	Equitrans Midstream Corporation	/etf/ea/ETZCW.djhtm?c=1&etfid=ETRN.US&back=MDY
FLR	Fluor Corporation	/etf/ea/ETZCW.djhtm?c=1&etfid=FLR.US&back=MDY
DOC	Physicians Realty Trust	/etf/ea/ETZCW.djhtm?c=1&etfid=DOC.US&back=MDY
MSM	MSC Industrial Direct Co. Inc. Class A	/etf/ea/ETZCW.djhtm?c=1&etfid=MSM.US&back=MDY
MMS	MAXIMUS Inc.	/etf/ea/ETZCW.djhtm?c=1&etfid=MMS.US&back=MDY
ZD	Ziff Davis Inc.	/etf/ea/ETZCW.djhtm?c=1&etfid=ZD.US&back=MDY
KSS	Kohl's Corporation	/etf/ea/ETZCW.djhtm?c=1&etfid=KSS.US&back=MDY
SR	Spire Inc.	/etf/ea/ETZCW.djhtm?c=1&etfid=SR.US&back=MDY
TNL	Travel + Leisure Co.	/etf/ea/ETZCW.djhtm?c=1&etfid=TNL.US&back=MDY
BHF	Brighthouse Financial Inc.	/etf/ea/ETZCW.djhtm?c=1&etfid=BHF.US&back=MDY
VNT	Vontier Corp	/etf/ea/ETZCW.djhtm?c=1&etfid=VNT.US&back=MDY
GO	Grocery Outlet Holding Corp.	/etf/ea/ETZCW.djhtm?c=1&etfid=GO.US&back=MDY
SBRA	Sabra Health Care REIT Inc.	/etf/ea/ETZCW.djhtm?c=1&etfid=SBRA.US&back=MDY
CNX	CNX Resources Corporation	/etf/ea/ETZCW.djhtm?c=1&etfid=CNX.US&back=MDY
TDC	Teradata Corporation	/etf/ea/ETZCW.djhtm?c=1&etfid=TDC.US&back=MDY
GATX	GATX Corporation	/etf/ea/ETZCW.djhtm?c=1&etfid=GATX.US&back=MDY
DEI	Douglas Emmett Inc	/etf/ea/ETZCW.djhtm?c=1&etfid=DEI.US&back=MDY
IART	Integra LifeSciences Holdings Corporation	/etf/ea/ETZCW.djhtm?c=1&etfid=IART.US&back=MDY
WING	Wingstop Inc.	/etf/ea/ETZCW.djhtm?c=1&etfid=WING.US&back=MDY
ALE	ALLETE Inc.	/etf/ea/ETZCW.djhtm?c=1&etfid=ALE.US&back=MDY
VC	Visteon Corporation	/etf/ea/ETZCW.djhtm?c=1&etfid=VC.US&back=MDY
SXT	Sensient Technologies Corporation	/etf/ea/ETZCW.djhtm?c=1&etfid=SXT.US&back=MDY
LANC	Lancaster Colony Corporation	/etf/ea/ETZCW.djhtm?c=1&etfid=LANC.US&back=MDY
DY	Dycom Industries Inc.	/etf/ea/ETZCW.djhtm?c=1&etfid=DY.US&back=MDY
WEN	Wendy's Company	/etf/ea/ETZCW.djhtm?c=1&etfid=WEN.US&back=MDY
AM	Antero Midstream Corp.	/etf/ea/ETZCW.djhtm?c=1&etfid=AM.US&back=MDY
CALX	Calix Inc.	/etf/ea/ETZCW.djhtm?c=1&etfid=CALX.US&back=MDY
PK	Park Hotels & Resorts Inc.	/etf/ea/ETZCW.djhtm?c=1&etfid=PK.US&back=MDY
EPR	EPR Properties	/etf/ea/ETZCW.djhtm?c=1&etfid=EPR.US&back=MDY
OLLI	Ollie's Bargain Outlet Holdings Inc	/etf/ea/ETZCW.djhtm?c=1&etfid=OLLI.US&back=MDY
PCH	PotlatchDeltic Corporation	/etf/ea/ETZCW.djhtm?c=1&etfid=PCH.US&back=MDY
HIW	Highwoods Properties Inc.	/etf/ea/ETZCW.djhtm?c=1&etfid=HIW.US&back=MDY
ICUI	ICU Medical Inc.	/etf/ea/ETZCW.djhtm?c=1&etfid=ICUI.US&back=MDY
YETI	YETI Holdings Inc.	/etf/ea/ETZCW.djhtm?c=1&etfid=YETI.US&back=MDY
SFM	Sprouts Farmers Market Inc.	/etf/ea/ETZCW.djhtm?c=1&etfid=SFM.US&back=MDY
SAM	Boston Beer Company Inc. Class A	/etf/ea/ETZCW.djhtm?c=1&etfid=SAM.US&back=MDY
CATY	Cathay General Bancorp	/etf/ea/ETZCW.djhtm?c=1&etfid=CATY.US&back=MDY
IPGP	IPG Photonics Corporation	/etf/ea/ETZCW.djhtm?c=1&etfid=IPGP.US&back=MDY
ADNT	Adient plc	/etf/ea/ETZCW.djhtm?c=1&etfid=ADNT.US&back=MDY
BOH	Bank of Hawaii Corp	/etf/ea/ETZCW.djhtm?c=1&etfid=BOH.US&back=MDY
FHI	Federated Hermes Inc. Class B	/etf/ea/ETZCW.djhtm?c=1&etfid=FHI.US&back=MDY
PACW	PacWest Bancorp	/etf/ea/ETZCW.djhtm?c=1&etfid=PACW.US&back=MDY
FL	Foot Locker Inc.	/etf/ea/ETZCW.djhtm?c=1&etfid=FL.US&back=MDY
FCFS	FirstCash Holdings Inc.	/etf/ea/ETZCW.djhtm?c=1&etfid=FCFS.US&back=MDY
HBI	Hanesbrands Inc.	/etf/ea/ETZCW.djhtm?c=1&etfid=HBI.US&back=MDY
ASB	Associated Banc-Corp	/etf/ea/ETZCW.djhtm?c=1&etfid=ASB.US&back=MDY
LIVN	LivaNova Plc	/etf/ea/ETZCW.djhtm?c=1&etfid=LIVN.US&back=MDY
TMHC	Taylor Morrison Home Corporation	/etf/ea/ETZCW.djhtm?c=1&etfid=TMHC.US&back=MDY
TCBI	Texas Capital Bancshares Inc.	/etf/ea/ETZCW.djhtm?c=1&etfid=TCBI.US&back=MDY
CRI	Carter's Inc.	/etf/ea/ETZCW.djhtm?c=1&etfid=CRI.US&back=MDY
HELE	Helen of Troy Limited	/etf/ea/ETZCW.djhtm?c=1&etfid=HELE.US&back=MDY
WWE	World Wrestling Entertainment Inc. Class A	/etf/ea/ETZCW.djhtm?c=1&etfid=WWE.US&back=MDY
RCM	R1 RCM Inc	/etf/ea/ETZCW.djhtm?c=1&etfid=RCM.US&back=MDY
SMTC	Semtech Corporation	/etf/ea/ETZCW.djhtm?c=1&etfid=SMTC.US&back=MDY
TNDM	Tandem Diabetes Care Inc.	/etf/ea/ETZCW.djhtm?c=1&etfid=TNDM.US&back=MDY
BRBR	BellRing Brands Inc.	/etf/ea/ETZCW.djhtm?c=1&etfid=BRBR.US&back=MDY
OFC	Corporate Office Properties Trust	/etf/ea/ETZCW.djhtm?c=1&etfid=OFC.US&back=MDY
BDC	Belden Inc.	/etf/ea/ETZCW.djhtm?c=1&etfid=BDC.US&back=MDY
ENV	Envestnet Inc.	/etf/ea/ETZCW.djhtm?c=1&etfid=ENV.US&back=MDY
NWE	NorthWestern Corporation	/etf/ea/ETZCW.djhtm?c=1&etfid=NWE.US&back=MDY
PGNY	Progyny Inc.	/etf/ea/ETZCW.djhtm?c=1&etfid=PGNY.US&back=MDY
SLG	SL Green Realty Corp.	/etf/ea/ETZCW.djhtm?c=1&etfid=SLG.US&back=MDY
VSAT	ViaSat Inc.	/etf/ea/ETZCW.djhtm?c=1&etfid=VSAT.US&back=MDY
MRCY	Mercury Systems Inc.	/etf/ea/ETZCW.djhtm?c=1&etfid=MRCY.US&back=MDY
KMPR	Kemper Corp	/etf/ea/ETZCW.djhtm?c=1&etfid=KMPR.US&back=MDY
ACIW	ACI Worldwide Inc.	/etf/ea/ETZCW.djhtm?c=1&etfid=ACIW.US&back=MDY
NGVT	Ingevity Corporation	/etf/ea/ETZCW.djhtm?c=1&etfid=NGVT.US&back=MDY
FULT	Fulton Financial Corporation	/etf/ea/ETZCW.djhtm?c=1&etfid=FULT.US&back=MDY
SMG	Scotts Miracle-Gro Company Class A	/etf/ea/ETZCW.djhtm?c=1&etfid=SMG.US&back=MDY
MTSI	MACOM Technology Solutions Holdings Inc.	/etf/ea/ETZCW.djhtm?c=1&etfid=MTSI.US&back=MDY
LOPE	Grand Canyon Education Inc.	/etf/ea/ETZCW.djhtm?c=1&etfid=LOPE.US&back=MDY
MP	MP Materials Corp Class A	/etf/ea/ETZCW.djhtm?c=1&etfid=MP.US&back=MDY
BCO	Brink's Company	/etf/ea/ETZCW.djhtm?c=1&etfid=BCO.US&back=MDY
VSH	Vishay Intertechnology Inc.	/etf/ea/ETZCW.djhtm?c=1&etfid=VSH.US&back=MDY
COTY	Coty Inc. Class A	/etf/ea/ETZCW.djhtm?c=1&etfid=COTY.US&back=MDY
PZZA	Papa John's International Inc.	/etf/ea/ETZCW.djhtm?c=1&etfid=PZZA.US&back=MDY
	Callaway Golf Company	
ENS	EnerSys	/etf/ea/ETZCW.djhtm?c=1&etfid=ENS.US&back=MDY
CBRL	Cracker Barrel Old Country Store Inc.	/etf/ea/ETZCW.djhtm?c=1&etfid=CBRL.US&back=MDY
JBLU	JetBlue Airways Corporation	/etf/ea/ETZCW.djhtm?c=1&etfid=JBLU.US&back=MDY
KBH	KB Home	/etf/ea/ETZCW.djhtm?c=1&etfid=KBH.US&back=MDY
PDCO	Patterson Companies Incorporated	/etf/ea/ETZCW.djhtm?c=1&etfid=PDCO.US&back=MDY
CVLT	CommVault Systems Inc.	/etf/ea/ETZCW.djhtm?c=1&etfid=CVLT.US&back=MDY
JBGS	JBG SMITH Properties	/etf/ea/ETZCW.djhtm?c=1&etfid=JBGS.US&back=MDY
TRIP	TripAdvisor Inc.	/etf/ea/ETZCW.djhtm?c=1&etfid=TRIP.US&back=MDY
BLKB	Blackbaud Inc.	/etf/ea/ETZCW.djhtm?c=1&etfid=BLKB.US&back=MDY
ENOV	Enovis Corporation	/etf/ea/ETZCW.djhtm?c=1&etfid=ENOV.US&back=MDY
COLM	Columbia Sportswear Company	/etf/ea/ETZCW.djhtm?c=1&etfid=COLM.US&back=MDY
NARI	Inari Medical Inc.	/etf/ea/ETZCW.djhtm?c=1&etfid=NARI.US&back=MDY
WERN	Werner Enterprises Inc.	/etf/ea/ETZCW.djhtm?c=1&etfid=WERN.US&back=MDY
SABR	Sabre Corp.	/etf/ea/ETZCW.djhtm?c=1&etfid=SABR.US&back=MDY
PEB	Pebblebrook Hotel Trust	/etf/ea/ETZCW.djhtm?c=1&etfid=PEB.US&back=MDY
TEX	Terex Corporation	/etf/ea/ETZCW.djhtm?c=1&etfid=TEX.US&back=MDY
NAVI	Navient Corp	/etf/ea/ETZCW.djhtm?c=1&etfid=NAVI.US&back=MDY
VSCO	Victoria's Secret & Company	/etf/ea/ETZCW.djhtm?c=1&etfid=VSCO.US&back=MDY
NEOG	Neogen Corporation	/etf/ea/ETZCW.djhtm?c=1&etfid=NEOG.US&back=MDY
DAN	Dana Incorporated	/etf/ea/ETZCW.djhtm?c=1&etfid=DAN.US&back=MDY
GHC	Graham Holdings Co. Class B	/etf/ea/ETZCW.djhtm?c=1&etfid=GHC.US&back=MDY
IBOC	International Bancshares Corporation	/etf/ea/ETZCW.djhtm?c=1&etfid=IBOC.US&back=MDY
NUVA	NuVasive Inc.	/etf/ea/ETZCW.djhtm?c=1&etfid=NUVA.US&back=MDY
COKE	Coca-Cola Consolidated Inc.	/etf/ea/ETZCW.djhtm?c=1&etfid=COKE.US&back=MDY
CNO	CNO Financial Group Inc.	/etf/ea/ETZCW.djhtm?c=1&etfid=CNO.US&back=MDY
MLKN	MillerKnoll Inc.	/etf/ea/ETZCW.djhtm?c=1&etfid=MLKN.US&back=MDY
WAFD	Washington Federal Inc.	/etf/ea/ETZCW.djhtm?c=1&etfid=WAFD.US&back=MDY
NUS	Nu Skin Enterprises Inc. Class A	/etf/ea/ETZCW.djhtm?c=1&etfid=NUS.US&back=MDY
MAC	Macerich Company	/etf/ea/ETZCW.djhtm?c=1&etfid=MAC.US&back=MDY
AMKR	Amkor Technology Inc.	/etf/ea/ETZCW.djhtm?c=1&etfid=AMKR.US&back=MDY
SPWR	SunPower Corporation	/etf/ea/ETZCW.djhtm?c=1&etfid=SPWR.US&back=MDY
WLY	John Wiley & Sons Inc. Class A	/etf/ea/ETZCW.djhtm?c=1&etfid=WLY.US&back=MDY
XRX	Xerox Holdings Corporation	/etf/ea/ETZCW.djhtm?c=1&etfid=XRX.US&back=MDY
NEU	NewMarket Corporation	/etf/ea/ETZCW.djhtm?c=1&etfid=NEU.US&back=MDY
KMT	Kennametal Inc.	/etf/ea/ETZCW.djhtm?c=1&etfid=KMT.US&back=MDY
GPS	Gap Inc.	/etf/ea/ETZCW.djhtm?c=1&etfid=GPS.US&back=MDY
MTX	Minerals Technologies Inc.	/etf/ea/ETZCW.djhtm?c=1&etfid=MTX.US&back=MDY
BFH	Bread Financial Holdings Inc.	/etf/ea/ETZCW.djhtm?c=1&etfid=BFH.US&back=MDY
HPP	Hudson Pacific Properties Inc.	/etf/ea/ETZCW.djhtm?c=1&etfid=HPP.US&back=MDY
JWN	Nordstrom Inc.	/etf/ea/ETZCW.djhtm?c=1&etfid=JWN.US&back=MDY
ESAB	ESAB Corporation	/etf/ea/ETZCW.djhtm?c=1&etfid=ESAB.US&back=MDY
KD	Kyndryl Holdings Incorporation	/etf/ea/ETZCW.djhtm?c=1&etfid=KD.US&back=MDY
ENR	Energizer Holdings Inc.	/etf/ea/ETZCW.djhtm?c=1&etfid=ENR.US&back=MDY
HAIN	Hain Celestial Group Inc.	/etf/ea/ETZCW.djhtm?c=1&etfid=HAIN.US&back=MDY
GEF	Greif Inc Class A	/etf/ea/ETZCW.djhtm?c=1&etfid=GEF.US&back=MDY
AEO	American Eagle Outfitters Inc.	/etf/ea/ETZCW.djhtm?c=1&etfid=AEO.US&back=MDY
SHC	Sotera Health Company	/etf/ea/ETZCW.djhtm?c=1&etfid=SHC.US&back=MDY
SITM	SiTime Corporation	/etf/ea/ETZCW.djhtm?c=1&etfid=SITM.US&back=MDY
WOR	Worthington Industries Inc.	/etf/ea/ETZCW.djhtm?c=1&etfid=WOR.US&back=MDY
UAA	Under Armour Inc. Class A	/etf/ea/ETZCW.djhtm?c=1&etfid=UAA.US&back=MDY
UA	Under Armour Inc. Class C	/etf/ea/ETZCW.djhtm?c=1&etfid=UA.US&back=MDY
VICR	Vicor Corporation	/etf/ea/ETZCW.djhtm?c=1&etfid=VICR.US&back=MDY
PPC	Pilgrim's Pride Corporation	/etf/ea/ETZCW.djhtm?c=1&etfid=PPC.US&back=MDY
MCY	Mercury General Corporation	/etf/ea/ETZCW.djhtm?c=1&etfid=MCY.US&back=MDY
