QDF
AAPL	APPLE INC COMMON STOCK USD 0.00001	/etf/ea/ETZCW.djhtm?c=1&etfid=AAPL.US&back=QDF
MSFT	MICROSOFT CORP COMMON STOCK USD 0.00000625	/etf/ea/ETZCW.djhtm?c=1&etfid=MSFT.US&back=QDF
PG	PROCTER & GAMBLE CO/THE COMMON STOCK USD 0	/etf/ea/ETZCW.djhtm?c=1&etfid=PG.US&back=QDF
JNJ	JOHNSON & JOHNSON COMMON STOCK USD 1	/etf/ea/ETZCW.djhtm?c=1&etfid=JNJ.US&back=QDF
JPM	JPMORGAN CHASE & CO COMMON STOCK USD 1	/etf/ea/ETZCW.djhtm?c=1&etfid=JPM.US&back=QDF
CSCO	CISCO SYSTEMS INC COMMON STOCK USD 0.001	/etf/ea/ETZCW.djhtm?c=1&etfid=CSCO.US&back=QDF
AVGO	BROADCOM INC COMMON STOCK USD	/etf/ea/ETZCW.djhtm?c=1&etfid=AVGO.US&back=QDF
LLY	ELI LILLY & CO COMMON STOCK USD 0	/etf/ea/ETZCW.djhtm?c=1&etfid=LLY.US&back=QDF
PM	PHILIP MORRIS INTERNATIONAL INC COMMON STOCK USD 0	/etf/ea/ETZCW.djhtm?c=1&etfid=PM.US&back=QDF
UPS	UNITED PARCEL SERVICE INC COMMON STOCK USD 0.01	/etf/ea/ETZCW.djhtm?c=1&etfid=UPS.US&back=QDF
TXN	TEXAS INSTRUMENTS INC COMMON STOCK USD 1	/etf/ea/ETZCW.djhtm?c=1&etfid=TXN.US&back=QDF
AMGN	AMGEN INC COMMON STOCK USD 0.0001	/etf/ea/ETZCW.djhtm?c=1&etfid=AMGN.US&back=QDF
HD	HOME DEPOT INC/THE COMMON STOCK USD 0.05	/etf/ea/ETZCW.djhtm?c=1&etfid=HD.US&back=QDF
UNP	UNION PACIFIC CORP COMMON STOCK USD 2.5	/etf/ea/ETZCW.djhtm?c=1&etfid=UNP.US&back=QDF
CMCSA	COMCAST CORP COMMON STOCK USD 0.01	/etf/ea/ETZCW.djhtm?c=1&etfid=CMCSA.US&back=QDF
IBM	INTERNATIONAL BUSINESS MACHINES CORP COMMON STOCK	/etf/ea/ETZCW.djhtm?c=1&etfid=IBM.US&back=QDF
ABT	ABBOTT LABORATORIES COMMON STOCK USD 0	/etf/ea/ETZCW.djhtm?c=1&etfid=ABT.US&back=QDF
LOW	LOWE'S COS INC COMMON STOCK USD 0.5	/etf/ea/ETZCW.djhtm?c=1&etfid=LOW.US&back=QDF
PFE	PFIZER INC COMMON STOCK USD 0.05	/etf/ea/ETZCW.djhtm?c=1&etfid=PFE.US&back=QDF
ACN	ACCENTURE PLC COMMON STOCK USD 0.0000225	/etf/ea/ETZCW.djhtm?c=1&etfid=ACN.US&back=QDF
MO	ALTRIA GROUP INC COMMON STOCK USD 0.333	/etf/ea/ETZCW.djhtm?c=1&etfid=MO.US&back=QDF
	S&P500 EMINI FUT EQUITY INDEX 16/SEP/2022 ESU2	
GILD	GILEAD SCIENCES INC COMMON STOCK USD 0.001	/etf/ea/ETZCW.djhtm?c=1&etfid=GILD.US&back=QDF
SO	SOUTHERN CO/THE COMMON STOCK USD 5	/etf/ea/ETZCW.djhtm?c=1&etfid=SO.US&back=QDF
MMM	3M CO COMMON STOCK USD 0.01	/etf/ea/ETZCW.djhtm?c=1&etfid=MMM.US&back=QDF
	CASH	
BAC	BANK OF AMERICA CORP COMMON STOCK USD 0.01	/etf/ea/ETZCW.djhtm?c=1&etfid=BAC.US&back=QDF
USB	US BANCORP COMMON STOCK USD 0.01	/etf/ea/ETZCW.djhtm?c=1&etfid=USB.US&back=QDF
UNH	UNITEDHEALTH GROUP INC COMMON STOCK USD 0.01	/etf/ea/ETZCW.djhtm?c=1&etfid=UNH.US&back=QDF
MCK	MCKESSON CORP COMMON STOCK USD 0.01	/etf/ea/ETZCW.djhtm?c=1&etfid=MCK.US&back=QDF
ITW	ILLINOIS TOOL WORKS INC COMMON STOCK USD 0.01	/etf/ea/ETZCW.djhtm?c=1&etfid=ITW.US&back=QDF
WSM	WILLIAMS-SONOMA INC COMMON STOCK USD 0.01	/etf/ea/ETZCW.djhtm?c=1&etfid=WSM.US&back=QDF
CAH	CARDINAL HEALTH INC COMMON STOCK USD 0	/etf/ea/ETZCW.djhtm?c=1&etfid=CAH.US&back=QDF
PSA	PUBLIC STORAGE REIT USD 0.1	/etf/ea/ETZCW.djhtm?c=1&etfid=PSA.US&back=QDF
LMT	LOCKHEED MARTIN CORP COMMON STOCK USD 1	/etf/ea/ETZCW.djhtm?c=1&etfid=LMT.US&back=QDF
MET	METLIFE INC COMMON STOCK USD 0.01	/etf/ea/ETZCW.djhtm?c=1&etfid=MET.US&back=QDF
AFL	AFLAC INC COMMON STOCK USD 0.1	/etf/ea/ETZCW.djhtm?c=1&etfid=AFL.US&back=QDF
PAYX	PAYCHEX INC COMMON STOCK USD 0.01	/etf/ea/ETZCW.djhtm?c=1&etfid=PAYX.US&back=QDF
DVN	DEVON ENERGY CORP COMMON STOCK	/etf/ea/ETZCW.djhtm?c=1&etfid=DVN.US&back=QDF
ABBV	ABBVIE INC COMMON STOCK USD 0.01	/etf/ea/ETZCW.djhtm?c=1&etfid=ABBV.US&back=QDF
NUE	NUCOR CORP COMMON STOCK USD 0.4	/etf/ea/ETZCW.djhtm?c=1&etfid=NUE.US&back=QDF
NKE	NIKE INC COMMON STOCK USD 0	/etf/ea/ETZCW.djhtm?c=1&etfid=NKE.US&back=QDF
TPR	TAPESTRY INC COMMON STOCK USD 0.01	/etf/ea/ETZCW.djhtm?c=1&etfid=TPR.US&back=QDF
AVB	AVALONBAY COMMUNITIES INC REIT USD 0.01	/etf/ea/ETZCW.djhtm?c=1&etfid=AVB.US&back=QDF
PFG	PRINCIPAL FINANCIAL GROUP INC COMMON STOCK USD	/etf/ea/ETZCW.djhtm?c=1&etfid=PFG.US&back=QDF
ALL	ALLSTATE CORP/THE COMMON STOCK USD 0.01	/etf/ea/ETZCW.djhtm?c=1&etfid=ALL.US&back=QDF
NXST	NEXSTAR MEDIA GROUP INC COMMON STOCK USD 0.01	/etf/ea/ETZCW.djhtm?c=1&etfid=NXST.US&back=QDF
PEG	PUBLIC SERVICE ENTERPRISE GROUP INC COMMON STOCK	/etf/ea/ETZCW.djhtm?c=1&etfid=PEG.US&back=QDF
CMA	COMERICA INC COMMON STOCK USD 5	/etf/ea/ETZCW.djhtm?c=1&etfid=CMA.US&back=QDF
NVDA	NVIDIA CORP COMMON STOCK USD 0.001	/etf/ea/ETZCW.djhtm?c=1&etfid=NVDA.US&back=QDF
EVRG	EVERGY INC COMMON STOCK USD 0	/etf/ea/ETZCW.djhtm?c=1&etfid=EVRG.US&back=QDF
CFR	CULLEN/FROST BANKERS INC COMMON STOCK USD 0.01	/etf/ea/ETZCW.djhtm?c=1&etfid=CFR.US&back=QDF
WEC	WEC ENERGY GROUP INC COMMON STOCK USD 0.01	/etf/ea/ETZCW.djhtm?c=1&etfid=WEC.US&back=QDF
PRU	PRUDENTIAL FINANCIAL INC COMMON STOCK USD 0.01	/etf/ea/ETZCW.djhtm?c=1&etfid=PRU.US&back=QDF
XOM	EXXON MOBIL CORP COMMON STOCK USD 0	/etf/ea/ETZCW.djhtm?c=1&etfid=XOM.US&back=QDF
SYF	SYNCHRONY FINANCIAL COMMON STOCK USD 0.001	/etf/ea/ETZCW.djhtm?c=1&etfid=SYF.US&back=QDF
BBY	BEST BUY CO INC COMMON STOCK USD 0.1	/etf/ea/ETZCW.djhtm?c=1&etfid=BBY.US&back=QDF
SNA	SNAP-ON INC COMMON STOCK USD 1	/etf/ea/ETZCW.djhtm?c=1&etfid=SNA.US&back=QDF
EQR	EQUITY RESIDENTIAL REIT USD 0.01	/etf/ea/ETZCW.djhtm?c=1&etfid=EQR.US&back=QDF
MRO	MARATHON OIL CORP COMMON STOCK USD 1	/etf/ea/ETZCW.djhtm?c=1&etfid=MRO.US&back=QDF
FCX	FREEPORT-MCMORAN INC COMMON STOCK USD 0.1	/etf/ea/ETZCW.djhtm?c=1&etfid=FCX.US&back=QDF
PDCE	PDC ENERGY INC COMMON STOCK USD 0.01	/etf/ea/ETZCW.djhtm?c=1&etfid=PDCE.US&back=QDF
FAST	FASTENAL CO COMMON STOCK USD 0.01	/etf/ea/ETZCW.djhtm?c=1&etfid=FAST.US&back=QDF
PB	PROSPERITY BANCSHARES INC COMMON STOCK USD 1	/etf/ea/ETZCW.djhtm?c=1&etfid=PB.US&back=QDF
TRGP	TARGA RESOURCES CORP COMMON STOCK USD 0.001	/etf/ea/ETZCW.djhtm?c=1&etfid=TRGP.US&back=QDF
TGNA	TEGNA INC COMMON STOCK USD 1	/etf/ea/ETZCW.djhtm?c=1&etfid=TGNA.US&back=QDF
SIRI	SIRIUS XM HOLDINGS INC COMMON STOCK USD 0.001	/etf/ea/ETZCW.djhtm?c=1&etfid=SIRI.US&back=QDF
AGNC	AGNC INVESTMENT CORP REIT USD 0.01	/etf/ea/ETZCW.djhtm?c=1&etfid=AGNC.US&back=QDF
RDN	RADIAN GROUP INC COMMON STOCK USD 0.001	/etf/ea/ETZCW.djhtm?c=1&etfid=RDN.US&back=QDF
T	AT&T INC COMMON STOCK USD 1	/etf/ea/ETZCW.djhtm?c=1&etfid=T.US&back=QDF
WY	WEYERHAEUSER CO REIT USD 1.25	/etf/ea/ETZCW.djhtm?c=1&etfid=WY.US&back=QDF
DOW	DOW INC COMMON STOCK USD 0.01	/etf/ea/ETZCW.djhtm?c=1&etfid=DOW.US&back=QDF
DFS	DISCOVER FINANCIAL SERVICES COMMON STOCK USD 0.01	/etf/ea/ETZCW.djhtm?c=1&etfid=DFS.US&back=QDF
ODFL	OLD DOMINION FREIGHT LINE INC COMMON STOCK USD 0.1	/etf/ea/ETZCW.djhtm?c=1&etfid=ODFL.US&back=QDF
REG	REGENCY CENTERS CORP REIT USD 0.01	/etf/ea/ETZCW.djhtm?c=1&etfid=REG.US&back=QDF
AIRC	APARTMENT INCOME REIT CORP REIT	/etf/ea/ETZCW.djhtm?c=1&etfid=AIRC.US&back=QDF
M	MACY'S INC COMMON STOCK USD 0.01	/etf/ea/ETZCW.djhtm?c=1&etfid=M.US&back=QDF
IPG	INTERPUBLIC GROUP OF COS INC/THE COMMON STOCK USD	/etf/ea/ETZCW.djhtm?c=1&etfid=IPG.US&back=QDF
PEAK	HEALTHPEAK PROPERTIES INC REIT USD 1	/etf/ea/ETZCW.djhtm?c=1&etfid=PEAK.US&back=QDF
LUMN	LUMEN TECHNOLOGIES INC COMMON STOCK USD 1	/etf/ea/ETZCW.djhtm?c=1&etfid=LUMN.US&back=QDF
NLOK	NORTONLIFELOCK INC COMMON STOCK	/etf/ea/ETZCW.djhtm?c=1&etfid=NLOK.US&back=QDF
ROL	ROLLINS INC COMMON STOCK USD 1	/etf/ea/ETZCW.djhtm?c=1&etfid=ROL.US&back=QDF
DKS	DICK'S SPORTING GOODS INC COMMON STOCK USD 0.01	/etf/ea/ETZCW.djhtm?c=1&etfid=DKS.US&back=QDF
ALLY	ALLY FINANCIAL INC COMMON STOCK USD 0.01	/etf/ea/ETZCW.djhtm?c=1&etfid=ALLY.US&back=QDF
PLD	PROLOGIS INC REIT USD 0.01	/etf/ea/ETZCW.djhtm?c=1&etfid=PLD.US&back=QDF
LNC	LINCOLN NATIONAL CORP COMMON STOCK USD 0	/etf/ea/ETZCW.djhtm?c=1&etfid=LNC.US&back=QDF
OLN	OLIN CORP COMMON STOCK USD 1	/etf/ea/ETZCW.djhtm?c=1&etfid=OLN.US&back=QDF
WU	WESTERN UNION CO/THE COMMON STOCK USD 0.01	/etf/ea/ETZCW.djhtm?c=1&etfid=WU.US&back=QDF
JHG	JANUS HENDERSON GROUP PLC COMMON STOCK USD 1.5	/etf/ea/ETZCW.djhtm?c=1&etfid=JHG.US&back=QDF
LYB	LYONDELLBASELL INDUSTRIES NV COMMON STOCK USD 0.04	/etf/ea/ETZCW.djhtm?c=1&etfid=LYB.US&back=QDF
LPX	LOUISIANA-PACIFIC CORP COMMON STOCK USD 1	/etf/ea/ETZCW.djhtm?c=1&etfid=LPX.US&back=QDF
EMN	EASTMAN CHEMICAL CO COMMON STOCK USD 0.01	/etf/ea/ETZCW.djhtm?c=1&etfid=EMN.US&back=QDF
V	VISA INC COMMON STOCK USD 0.0001	/etf/ea/ETZCW.djhtm?c=1&etfid=V.US&back=QDF
RL	RALPH LAUREN CORP COMMON STOCK USD 0.01	/etf/ea/ETZCW.djhtm?c=1&etfid=RL.US&back=QDF
AOS	A O SMITH CORP COMMON STOCK USD 1	/etf/ea/ETZCW.djhtm?c=1&etfid=AOS.US&back=QDF
TGT	TARGET CORP COMMON STOCK USD 0.0833	/etf/ea/ETZCW.djhtm?c=1&etfid=TGT.US&back=QDF
HIW	HIGHWOODS PROPERTIES INC REIT USD 0.01	/etf/ea/ETZCW.djhtm?c=1&etfid=HIW.US&back=QDF
IP	INTERNATIONAL PAPER CO COMMON STOCK USD 1	/etf/ea/ETZCW.djhtm?c=1&etfid=IP.US&back=QDF
STX	SEAGATE TECHNOLOGY HOLDINGS	/etf/ea/ETZCW.djhtm?c=1&etfid=STX.US&back=QDF
LAMR	LAMAR ADVERTISING CO REIT USD 0.001	/etf/ea/ETZCW.djhtm?c=1&etfid=LAMR.US&back=QDF
RHI	ROBERT HALF INTERNATIONAL INC COMMON STOCK USD	/etf/ea/ETZCW.djhtm?c=1&etfid=RHI.US&back=QDF
OMF	ONEMAIN HOLDINGS INC COMMON STOCK USD 0.01	/etf/ea/ETZCW.djhtm?c=1&etfid=OMF.US&back=QDF
CVX	CHEVRON CORP COMMON STOCK USD 0.75	/etf/ea/ETZCW.djhtm?c=1&etfid=CVX.US&back=QDF
ATVI	ACTIVISION BLIZZARD INC COMMON STOCK USD 0.000001	/etf/ea/ETZCW.djhtm?c=1&etfid=ATVI.US&back=QDF
ORCL	ORACLE CORP COMMON STOCK USD 0.01	/etf/ea/ETZCW.djhtm?c=1&etfid=ORCL.US&back=QDF
AES	AES CORP/THE COMMON STOCK USD 0.01	/etf/ea/ETZCW.djhtm?c=1&etfid=AES.US&back=QDF
SLG	SL GREEN REALTY	/etf/ea/ETZCW.djhtm?c=1&etfid=SLG.US&back=QDF
MA	MASTERCARD INC COMMON STOCK USD 0.0001	/etf/ea/ETZCW.djhtm?c=1&etfid=MA.US&back=QDF
PXD	PIONEER NATURAL RESOURCES CO COMMON STOCK USD 0.01	/etf/ea/ETZCW.djhtm?c=1&etfid=PXD.US&back=QDF
BBWI	BATH & BODY WORKS INC COMMON STOCK USD 0.5	/etf/ea/ETZCW.djhtm?c=1&etfid=BBWI.US&back=QDF
CL	COLGATE-PALMOLIVE CO COMMON STOCK USD 1	/etf/ea/ETZCW.djhtm?c=1&etfid=CL.US&back=QDF
KO	COCA-COLA CO/THE COMMON STOCK USD 0.25	/etf/ea/ETZCW.djhtm?c=1&etfid=KO.US&back=QDF
CTAS	CINTAS CORP COMMON STOCK USD 0	/etf/ea/ETZCW.djhtm?c=1&etfid=CTAS.US&back=QDF
EBAY	EBAY INC COMMON STOCK USD 0.001	/etf/ea/ETZCW.djhtm?c=1&etfid=EBAY.US&back=QDF
IGT	INTERNATIONAL GAME TECHNOLOGY PLC COMMON STOCK USD	/etf/ea/ETZCW.djhtm?c=1&etfid=IGT.US&back=QDF
KSS	KOHL'S CORP COMMON STOCK USD 0.01	/etf/ea/ETZCW.djhtm?c=1&etfid=KSS.US&back=QDF
NLY	ANNALY CAPITAL MANAGEMENT INC REIT USD 0.01	/etf/ea/ETZCW.djhtm?c=1&etfid=NLY.US&back=QDF
OMC	OMNICOM GROUP INC COMMON STOCK USD 0.15	/etf/ea/ETZCW.djhtm?c=1&etfid=OMC.US&back=QDF
MRK	MERCK & CO INC COMMON STOCK USD 0.5	/etf/ea/ETZCW.djhtm?c=1&etfid=MRK.US&back=QDF
NYT	NEW YORK TIMES CO/THE COMMON STOCK USD 0.1	/etf/ea/ETZCW.djhtm?c=1&etfid=NYT.US&back=QDF
PEP	PEPSICO INC COMMON STOCK USD 0.017	/etf/ea/ETZCW.djhtm?c=1&etfid=PEP.US&back=QDF
DPZ	DOMINO'S PIZZA INC COMMON STOCK USD 0.01	/etf/ea/ETZCW.djhtm?c=1&etfid=DPZ.US&back=QDF
TRV	TRAVELERS COS INC/THE COMMON STOCK USD 0	/etf/ea/ETZCW.djhtm?c=1&etfid=TRV.US&back=QDF
VZ	VERIZON COMMUNICATIONS INC COMMON STOCK USD 0.1	/etf/ea/ETZCW.djhtm?c=1&etfid=VZ.US&back=QDF
COST	COSTCO WHOLESALE CORP COMMON STOCK USD 0.005	/etf/ea/ETZCW.djhtm?c=1&etfid=COST.US&back=QDF
	U.S. DOLLAR FOR FUTURES	
