QDYN
AAPL	APPLE INC COMMON STOCK USD 0.00001	/etf/ea/ETZCW.djhtm?c=1&etfid=AAPL.US&back=QDYN
MSFT	MICROSOFT CORP COMMON STOCK USD 0.00000625	/etf/ea/ETZCW.djhtm?c=1&etfid=MSFT.US&back=QDYN
JNJ	JOHNSON & JOHNSON COMMON STOCK USD 1	/etf/ea/ETZCW.djhtm?c=1&etfid=JNJ.US&back=QDYN
PFE	PFIZER INC COMMON STOCK USD 0.05	/etf/ea/ETZCW.djhtm?c=1&etfid=PFE.US&back=QDYN
JPM	JPMORGAN CHASE & CO COMMON STOCK USD 1	/etf/ea/ETZCW.djhtm?c=1&etfid=JPM.US&back=QDYN
CSCO	CISCO SYSTEMS INC COMMON STOCK USD 0.001	/etf/ea/ETZCW.djhtm?c=1&etfid=CSCO.US&back=QDYN
AVGO	BROADCOM INC COMMON STOCK USD	/etf/ea/ETZCW.djhtm?c=1&etfid=AVGO.US&back=QDYN
	SP500 MIC EMIN FUT EQUITY INDEX 16/SEP/2022 HWAU2	
UPS	UNITED PARCEL SERVICE INC COMMON STOCK USD 0.01	/etf/ea/ETZCW.djhtm?c=1&etfid=UPS.US&back=QDYN
UNP	UNION PACIFIC CORP COMMON STOCK USD 2.5	/etf/ea/ETZCW.djhtm?c=1&etfid=UNP.US&back=QDYN
TXN	TEXAS INSTRUMENTS INC COMMON STOCK USD 1	/etf/ea/ETZCW.djhtm?c=1&etfid=TXN.US&back=QDYN
PM	PHILIP MORRIS INTERNATIONAL INC COMMON STOCK USD 0	/etf/ea/ETZCW.djhtm?c=1&etfid=PM.US&back=QDYN
ACN	ACCENTURE PLC COMMON STOCK USD 0.0000225	/etf/ea/ETZCW.djhtm?c=1&etfid=ACN.US&back=QDYN
AMGN	AMGEN INC COMMON STOCK USD 0.0001	/etf/ea/ETZCW.djhtm?c=1&etfid=AMGN.US&back=QDYN
LOW	LOWE'S COS INC COMMON STOCK USD 0.5	/etf/ea/ETZCW.djhtm?c=1&etfid=LOW.US&back=QDYN
CMCSA	COMCAST CORP COMMON STOCK USD 0.01	/etf/ea/ETZCW.djhtm?c=1&etfid=CMCSA.US&back=QDYN
IBM	INTERNATIONAL BUSINESS MACHINES CORP COMMON STOCK	/etf/ea/ETZCW.djhtm?c=1&etfid=IBM.US&back=QDYN
C	CITIGROUP INC COMMON STOCK USD 0.01	/etf/ea/ETZCW.djhtm?c=1&etfid=C.US&back=QDYN
	CASH	
BAC	BANK OF AMERICA CORP COMMON STOCK USD 0.01	/etf/ea/ETZCW.djhtm?c=1&etfid=BAC.US&back=QDYN
MO	ALTRIA GROUP INC COMMON STOCK USD 0.333	/etf/ea/ETZCW.djhtm?c=1&etfid=MO.US&back=QDYN
MMM	3M CO COMMON STOCK USD 0.01	/etf/ea/ETZCW.djhtm?c=1&etfid=MMM.US&back=QDYN
OXY	OCCIDENTAL PETROLEUM CORP COMMON STOCK USD 0.2	/etf/ea/ETZCW.djhtm?c=1&etfid=OXY.US&back=QDYN
TGT	TARGET CORP COMMON STOCK USD 0.0833	/etf/ea/ETZCW.djhtm?c=1&etfid=TGT.US&back=QDYN
AMAT	APPLIED MATERIALS INC COMMON STOCK USD 0.01	/etf/ea/ETZCW.djhtm?c=1&etfid=AMAT.US&back=QDYN
UNH	UNITEDHEALTH GROUP INC COMMON STOCK USD 0.01	/etf/ea/ETZCW.djhtm?c=1&etfid=UNH.US&back=QDYN
WSM	WILLIAMS-SONOMA INC COMMON STOCK USD 0.01	/etf/ea/ETZCW.djhtm?c=1&etfid=WSM.US&back=QDYN
LRCX	LAM RESEARCH CORP COMMON STOCK USD 0.001	/etf/ea/ETZCW.djhtm?c=1&etfid=LRCX.US&back=QDYN
ABBV	ABBVIE INC COMMON STOCK USD 0.01	/etf/ea/ETZCW.djhtm?c=1&etfid=ABBV.US&back=QDYN
ITW	ILLINOIS TOOL WORKS INC COMMON STOCK USD 0.01	/etf/ea/ETZCW.djhtm?c=1&etfid=ITW.US&back=QDYN
DKS	DICK'S SPORTING GOODS INC COMMON STOCK USD 0.01	/etf/ea/ETZCW.djhtm?c=1&etfid=DKS.US&back=QDYN
AFL	AFLAC INC COMMON STOCK USD 0.1	/etf/ea/ETZCW.djhtm?c=1&etfid=AFL.US&back=QDYN
T	AT&T INC COMMON STOCK USD 1	/etf/ea/ETZCW.djhtm?c=1&etfid=T.US&back=QDYN
NUE	NUCOR CORP COMMON STOCK USD 0.4	/etf/ea/ETZCW.djhtm?c=1&etfid=NUE.US&back=QDYN
MET	METLIFE INC COMMON STOCK USD 0.01	/etf/ea/ETZCW.djhtm?c=1&etfid=MET.US&back=QDYN
XOM	EXXON MOBIL CORP COMMON STOCK USD 0	/etf/ea/ETZCW.djhtm?c=1&etfid=XOM.US&back=QDYN
AMP	AMERIPRISE FINANCIAL INC COMMON STOCK USD 0.01	/etf/ea/ETZCW.djhtm?c=1&etfid=AMP.US&back=QDYN
NXST	NEXSTAR MEDIA GROUP INC COMMON STOCK USD 0.01	/etf/ea/ETZCW.djhtm?c=1&etfid=NXST.US&back=QDYN
AVB	AVALONBAY COMMUNITIES INC REIT USD 0.01	/etf/ea/ETZCW.djhtm?c=1&etfid=AVB.US&back=QDYN
UNM	UNUM GROUP COMMON STOCK USD 0.1	/etf/ea/ETZCW.djhtm?c=1&etfid=UNM.US&back=QDYN
DVN	DEVON ENERGY CORP COMMON STOCK	/etf/ea/ETZCW.djhtm?c=1&etfid=DVN.US&back=QDYN
PG	PROCTER & GAMBLE CO/THE COMMON STOCK USD 0	/etf/ea/ETZCW.djhtm?c=1&etfid=PG.US&back=QDYN
TPR	TAPESTRY INC COMMON STOCK USD 0.01	/etf/ea/ETZCW.djhtm?c=1&etfid=TPR.US&back=QDYN
CTAS	CINTAS CORP COMMON STOCK USD 0	/etf/ea/ETZCW.djhtm?c=1&etfid=CTAS.US&back=QDYN
ROP	ROPER TECHNOLOGIES INC COMMON STOCK USD 0.01	/etf/ea/ETZCW.djhtm?c=1&etfid=ROP.US&back=QDYN
SPG	SIMON PROPERTY GROUP INC REIT USD 0.0001	/etf/ea/ETZCW.djhtm?c=1&etfid=SPG.US&back=QDYN
	U.S. DOLLAR FOR FUTURES	
GWW	WW GRAINGER INC COMMON STOCK USD 0.5	/etf/ea/ETZCW.djhtm?c=1&etfid=GWW.US&back=QDYN
RRR	RED ROCK RESORTS INC COMMON STOCK USD 0.01	/etf/ea/ETZCW.djhtm?c=1&etfid=RRR.US&back=QDYN
FAST	FASTENAL CO COMMON STOCK USD 0.01	/etf/ea/ETZCW.djhtm?c=1&etfid=FAST.US&back=QDYN
SNA	SNAP-ON INC COMMON STOCK USD 1	/etf/ea/ETZCW.djhtm?c=1&etfid=SNA.US&back=QDYN
CMA	COMERICA INC COMMON STOCK USD 5	/etf/ea/ETZCW.djhtm?c=1&etfid=CMA.US&back=QDYN
MRO	MARATHON OIL CORP COMMON STOCK USD 1	/etf/ea/ETZCW.djhtm?c=1&etfid=MRO.US&back=QDYN
TRGP	TARGA RESOURCES CORP COMMON STOCK USD 0.001	/etf/ea/ETZCW.djhtm?c=1&etfid=TRGP.US&back=QDYN
PDCE	PDC ENERGY INC COMMON STOCK USD 0.01	/etf/ea/ETZCW.djhtm?c=1&etfid=PDCE.US&back=QDYN
PAYX	PAYCHEX INC COMMON STOCK USD 0.01	/etf/ea/ETZCW.djhtm?c=1&etfid=PAYX.US&back=QDYN
APA	APA CORP COMMON STOCK USD 0.625	/etf/ea/ETZCW.djhtm?c=1&etfid=APA.US&back=QDYN
WY	WEYERHAEUSER CO REIT USD 1.25	/etf/ea/ETZCW.djhtm?c=1&etfid=WY.US&back=QDYN
PFG	PRINCIPAL FINANCIAL GROUP INC COMMON STOCK USD	/etf/ea/ETZCW.djhtm?c=1&etfid=PFG.US&back=QDYN
BBY	BEST BUY CO INC COMMON STOCK USD 0.1	/etf/ea/ETZCW.djhtm?c=1&etfid=BBY.US&back=QDYN
CAH	CARDINAL HEALTH INC COMMON STOCK USD 0	/etf/ea/ETZCW.djhtm?c=1&etfid=CAH.US&back=QDYN
EMR	EMERSON ELECTRIC CO COMMON STOCK USD 0.5	/etf/ea/ETZCW.djhtm?c=1&etfid=EMR.US&back=QDYN
TGNA	TEGNA INC COMMON STOCK USD 1	/etf/ea/ETZCW.djhtm?c=1&etfid=TGNA.US&back=QDYN
REG	REGENCY CENTERS CORP REIT USD 0.01	/etf/ea/ETZCW.djhtm?c=1&etfid=REG.US&back=QDYN
DOW	DOW INC COMMON STOCK USD 0.01	/etf/ea/ETZCW.djhtm?c=1&etfid=DOW.US&back=QDYN
SIRI	SIRIUS XM HOLDINGS INC COMMON STOCK USD 0.001	/etf/ea/ETZCW.djhtm?c=1&etfid=SIRI.US&back=QDYN
FCX	FREEPORT-MCMORAN INC COMMON STOCK USD 0.1	/etf/ea/ETZCW.djhtm?c=1&etfid=FCX.US&back=QDYN
COF	CAPITAL ONE FINANCIAL CORP COMMON STOCK USD 0.01	/etf/ea/ETZCW.djhtm?c=1&etfid=COF.US&back=QDYN
FANG	DIAMONDBACK ENERGY INC COMMON STOCK USD 0.01	/etf/ea/ETZCW.djhtm?c=1&etfid=FANG.US&back=QDYN
PRU	PRUDENTIAL FINANCIAL INC COMMON STOCK USD 0.01	/etf/ea/ETZCW.djhtm?c=1&etfid=PRU.US&back=QDYN
NVDA	NVIDIA CORP COMMON STOCK USD 0.001	/etf/ea/ETZCW.djhtm?c=1&etfid=NVDA.US&back=QDYN
OC	OWENS CORNING COMMON STOCK USD 0.001	/etf/ea/ETZCW.djhtm?c=1&etfid=OC.US&back=QDYN
DFS	DISCOVER FINANCIAL SERVICES COMMON STOCK USD 0.01	/etf/ea/ETZCW.djhtm?c=1&etfid=DFS.US&back=QDYN
RHI	ROBERT HALF INTERNATIONAL INC COMMON STOCK USD	/etf/ea/ETZCW.djhtm?c=1&etfid=RHI.US&back=QDYN
JHG	JANUS HENDERSON GROUP PLC COMMON STOCK USD 1.5	/etf/ea/ETZCW.djhtm?c=1&etfid=JHG.US&back=QDYN
M	MACY'S INC COMMON STOCK USD 0.01	/etf/ea/ETZCW.djhtm?c=1&etfid=M.US&back=QDYN
AGNC	AGNC INVESTMENT CORP REIT USD 0.01	/etf/ea/ETZCW.djhtm?c=1&etfid=AGNC.US&back=QDYN
EQR	EQUITY RESIDENTIAL REIT USD 0.01	/etf/ea/ETZCW.djhtm?c=1&etfid=EQR.US&back=QDYN
LYB	LYONDELLBASELL INDUSTRIES NV COMMON STOCK USD 0.04	/etf/ea/ETZCW.djhtm?c=1&etfid=LYB.US&back=QDYN
CC	CHEMOURS CO/THE COMMON STOCK USD 0.01	/etf/ea/ETZCW.djhtm?c=1&etfid=CC.US&back=QDYN
LNC	LINCOLN NATIONAL CORP COMMON STOCK USD 0	/etf/ea/ETZCW.djhtm?c=1&etfid=LNC.US&back=QDYN
ABT	ABBOTT LABORATORIES COMMON STOCK USD 0	/etf/ea/ETZCW.djhtm?c=1&etfid=ABT.US&back=QDYN
V	VISA INC COMMON STOCK USD 0.0001	/etf/ea/ETZCW.djhtm?c=1&etfid=V.US&back=QDYN
MCHP	MICROCHIP TECHNOLOGY INC COMMON STOCK USD 0.001	/etf/ea/ETZCW.djhtm?c=1&etfid=MCHP.US&back=QDYN
VOYA	VOYA FINANCIAL INC COMMON STOCK USD 0.01	/etf/ea/ETZCW.djhtm?c=1&etfid=VOYA.US&back=QDYN
IGT	INTERNATIONAL GAME TECHNOLOGY PLC COMMON STOCK USD	/etf/ea/ETZCW.djhtm?c=1&etfid=IGT.US&back=QDYN
CFR	CULLEN/FROST BANKERS INC COMMON STOCK USD 0.01	/etf/ea/ETZCW.djhtm?c=1&etfid=CFR.US&back=QDYN
CR	CRANE HOLDINGS CO COMMON STOCK USD 1	/etf/ea/ETZCW.djhtm?c=1&etfid=CR.US&back=QDYN
LPX	LOUISIANA-PACIFIC CORP COMMON STOCK USD 1	/etf/ea/ETZCW.djhtm?c=1&etfid=LPX.US&back=QDYN
LAMR	LAMAR ADVERTISING CO REIT USD 0.001	/etf/ea/ETZCW.djhtm?c=1&etfid=LAMR.US&back=QDYN
MAS	MASCO CORP COMMON STOCK USD 1	/etf/ea/ETZCW.djhtm?c=1&etfid=MAS.US&back=QDYN
IPG	INTERPUBLIC GROUP OF COS INC/THE COMMON STOCK USD	/etf/ea/ETZCW.djhtm?c=1&etfid=IPG.US&back=QDYN
BRX	BRIXMOR PROPERTY GROUP INC REIT USD 0.01	/etf/ea/ETZCW.djhtm?c=1&etfid=BRX.US&back=QDYN
LUMN	LUMEN TECHNOLOGIES INC COMMON STOCK USD 1	/etf/ea/ETZCW.djhtm?c=1&etfid=LUMN.US&back=QDYN
WU	WESTERN UNION CO/THE COMMON STOCK USD 0.01	/etf/ea/ETZCW.djhtm?c=1&etfid=WU.US&back=QDYN
NLOK	NORTONLIFELOCK INC COMMON STOCK	/etf/ea/ETZCW.djhtm?c=1&etfid=NLOK.US&back=QDYN
AES	AES CORP/THE COMMON STOCK USD 0.01	/etf/ea/ETZCW.djhtm?c=1&etfid=AES.US&back=QDYN
AOS	A O SMITH CORP COMMON STOCK USD 1	/etf/ea/ETZCW.djhtm?c=1&etfid=AOS.US&back=QDYN
SLG	SL GREEN REALTY	/etf/ea/ETZCW.djhtm?c=1&etfid=SLG.US&back=QDYN
HD	HOME DEPOT INC/THE COMMON STOCK USD 0.05	/etf/ea/ETZCW.djhtm?c=1&etfid=HD.US&back=QDYN
STX	SEAGATE TECHNOLOGY HOLDINGS	/etf/ea/ETZCW.djhtm?c=1&etfid=STX.US&back=QDYN
EMN	EASTMAN CHEMICAL CO COMMON STOCK USD 0.01	/etf/ea/ETZCW.djhtm?c=1&etfid=EMN.US&back=QDYN
SYF	SYNCHRONY FINANCIAL COMMON STOCK USD 0.001	/etf/ea/ETZCW.djhtm?c=1&etfid=SYF.US&back=QDYN
EQH	EQUITABLE HOLDINGS INC COMMON STOCK USD 0.01	/etf/ea/ETZCW.djhtm?c=1&etfid=EQH.US&back=QDYN
RL	RALPH LAUREN CORP COMMON STOCK USD 0.01	/etf/ea/ETZCW.djhtm?c=1&etfid=RL.US&back=QDYN
PPL	PPL CORP COMMON STOCK USD 0.01	/etf/ea/ETZCW.djhtm?c=1&etfid=PPL.US&back=QDYN
HIW	HIGHWOODS PROPERTIES INC REIT USD 0.01	/etf/ea/ETZCW.djhtm?c=1&etfid=HIW.US&back=QDYN
KSS	KOHL'S CORP COMMON STOCK USD 0.01	/etf/ea/ETZCW.djhtm?c=1&etfid=KSS.US&back=QDYN
CVX	CHEVRON CORP COMMON STOCK USD 0.75	/etf/ea/ETZCW.djhtm?c=1&etfid=CVX.US&back=QDYN
ORCL	ORACLE CORP COMMON STOCK USD 0.01	/etf/ea/ETZCW.djhtm?c=1&etfid=ORCL.US&back=QDYN
OLN	OLIN CORP COMMON STOCK USD 1	/etf/ea/ETZCW.djhtm?c=1&etfid=OLN.US&back=QDYN
PXD	PIONEER NATURAL RESOURCES CO COMMON STOCK USD 0.01	/etf/ea/ETZCW.djhtm?c=1&etfid=PXD.US&back=QDYN
MA	MASTERCARD INC COMMON STOCK USD 0.0001	/etf/ea/ETZCW.djhtm?c=1&etfid=MA.US&back=QDYN
OMF	ONEMAIN HOLDINGS INC COMMON STOCK USD 0.01	/etf/ea/ETZCW.djhtm?c=1&etfid=OMF.US&back=QDYN
BBWI	BATH & BODY WORKS INC COMMON STOCK USD 0.5	/etf/ea/ETZCW.djhtm?c=1&etfid=BBWI.US&back=QDYN
IP	INTERNATIONAL PAPER CO COMMON STOCK USD 1	/etf/ea/ETZCW.djhtm?c=1&etfid=IP.US&back=QDYN
KO	COCA-COLA CO/THE COMMON STOCK USD 0.25	/etf/ea/ETZCW.djhtm?c=1&etfid=KO.US&back=QDYN
PAGP	PLAINS GP HOLDINGS LP COMMON STOCK USD	/etf/ea/ETZCW.djhtm?c=1&etfid=PAGP.US&back=QDYN
AM	ANTERO MIDSTREAM CORP COMMON STOCK USD	/etf/ea/ETZCW.djhtm?c=1&etfid=AM.US&back=QDYN
OMC	OMNICOM GROUP INC COMMON STOCK USD 0.15	/etf/ea/ETZCW.djhtm?c=1&etfid=OMC.US&back=QDYN
ATVI	ACTIVISION BLIZZARD INC COMMON STOCK USD 0.000001	/etf/ea/ETZCW.djhtm?c=1&etfid=ATVI.US&back=QDYN
PEP	PEPSICO INC COMMON STOCK USD 0.017	/etf/ea/ETZCW.djhtm?c=1&etfid=PEP.US&back=QDYN
LLY	ELI LILLY & CO COMMON STOCK USD 0	/etf/ea/ETZCW.djhtm?c=1&etfid=LLY.US&back=QDYN
OKE	ONEOK INC COMMON STOCK USD 0.01	/etf/ea/ETZCW.djhtm?c=1&etfid=OKE.US&back=QDYN
X	UNITED STATES STEEL CORP COMMON STOCK USD 1	/etf/ea/ETZCW.djhtm?c=1&etfid=X.US&back=QDYN
NLY	ANNALY CAPITAL MANAGEMENT INC REIT USD 0.01	/etf/ea/ETZCW.djhtm?c=1&etfid=NLY.US&back=QDYN
ALLY	ALLY FINANCIAL INC COMMON STOCK USD 0.01	/etf/ea/ETZCW.djhtm?c=1&etfid=ALLY.US&back=QDYN
USB	US BANCORP COMMON STOCK USD 0.01	/etf/ea/ETZCW.djhtm?c=1&etfid=USB.US&back=QDYN
COST	COSTCO WHOLESALE CORP COMMON STOCK USD 0.005	/etf/ea/ETZCW.djhtm?c=1&etfid=COST.US&back=QDYN
MRK	MERCK & CO INC COMMON STOCK USD 0.5	/etf/ea/ETZCW.djhtm?c=1&etfid=MRK.US&back=QDYN
VZ	VERIZON COMMUNICATIONS INC COMMON STOCK USD 0.1	/etf/ea/ETZCW.djhtm?c=1&etfid=VZ.US&back=QDYN
G	GENPACT LTD COMMON STOCK USD 0.01	/etf/ea/ETZCW.djhtm?c=1&etfid=G.US&back=QDYN
CUZ	COUSINS PROPERTIES INC REIT USD 1	/etf/ea/ETZCW.djhtm?c=1&etfid=CUZ.US&back=QDYN
