QUAL
SPGI	S&P GLOBAL INC	/etf/ea/ETZCW.djhtm?c=1&etfid=SPGI.US&back=QUAL
AAPL	APPLE INC	/etf/ea/ETZCW.djhtm?c=1&etfid=AAPL.US&back=QUAL
JNJ	JOHNSON & JOHNSON	/etf/ea/ETZCW.djhtm?c=1&etfid=JNJ.US&back=QUAL
NKE	NIKE INC CLASS B	/etf/ea/ETZCW.djhtm?c=1&etfid=NKE.US&back=QUAL
MSFT	MICROSOFT CORP	/etf/ea/ETZCW.djhtm?c=1&etfid=MSFT.US&back=QUAL
META	META PLATFORMS INC CLASS A	/etf/ea/ETZCW.djhtm?c=1&etfid=META.US&back=QUAL
LLY	ELI LILLY	/etf/ea/ETZCW.djhtm?c=1&etfid=LLY.US&back=QUAL
NVDA	NVIDIA CORP	/etf/ea/ETZCW.djhtm?c=1&etfid=NVDA.US&back=QUAL
MA	MASTERCARD INC CLASS A	/etf/ea/ETZCW.djhtm?c=1&etfid=MA.US&back=QUAL
KO	COCA-COLA	/etf/ea/ETZCW.djhtm?c=1&etfid=KO.US&back=QUAL
V	VISA INC CLASS A	/etf/ea/ETZCW.djhtm?c=1&etfid=V.US&back=QUAL
COST	COSTCO WHOLESALE CORP	/etf/ea/ETZCW.djhtm?c=1&etfid=COST.US&back=QUAL
TGT	TARGET CORP	/etf/ea/ETZCW.djhtm?c=1&etfid=TGT.US&back=QUAL
PFE	PFIZER INC	/etf/ea/ETZCW.djhtm?c=1&etfid=PFE.US&back=QUAL
BX	BLACKSTONE INC	/etf/ea/ETZCW.djhtm?c=1&etfid=BX.US&back=QUAL
GOOGL	ALPHABET INC CLASS A	/etf/ea/ETZCW.djhtm?c=1&etfid=GOOGL.US&back=QUAL
UPS	UNITED PARCEL SERVICE INC CLASS B	/etf/ea/ETZCW.djhtm?c=1&etfid=UPS.US&back=QUAL
GOOG	ALPHABET INC CLASS C	/etf/ea/ETZCW.djhtm?c=1&etfid=GOOG.US&back=QUAL
MRK	MERCK & CO INC	/etf/ea/ETZCW.djhtm?c=1&etfid=MRK.US&back=QUAL
LMT	LOCKHEED MARTIN CORP	/etf/ea/ETZCW.djhtm?c=1&etfid=LMT.US&back=QUAL
ATO	ATMOS ENERGY CORP	/etf/ea/ETZCW.djhtm?c=1&etfid=ATO.US&back=QUAL
MCO	MOODYS CORP	/etf/ea/ETZCW.djhtm?c=1&etfid=MCO.US&back=QUAL
NRG	NRG ENERGY INC	/etf/ea/ETZCW.djhtm?c=1&etfid=NRG.US&back=QUAL
TXN	TEXAS INSTRUMENT INC	/etf/ea/ETZCW.djhtm?c=1&etfid=TXN.US&back=QUAL
QCOM	QUALCOMM INC	/etf/ea/ETZCW.djhtm?c=1&etfid=QCOM.US&back=QUAL
ACN	ACCENTURE PLC CLASS A	/etf/ea/ETZCW.djhtm?c=1&etfid=ACN.US&back=QUAL
CSCO	CISCO SYSTEMS INC	/etf/ea/ETZCW.djhtm?c=1&etfid=CSCO.US&back=QUAL
MPC	MARATHON PETROLEUM CORP	/etf/ea/ETZCW.djhtm?c=1&etfid=MPC.US&back=QUAL
ADBE	ADOBE INC	/etf/ea/ETZCW.djhtm?c=1&etfid=ADBE.US&back=QUAL
LULU	LULULEMON ATHLETICA INC	/etf/ea/ETZCW.djhtm?c=1&etfid=LULU.US&back=QUAL
SLB	SCHLUMBERGER NV	/etf/ea/ETZCW.djhtm?c=1&etfid=SLB.US&back=QUAL
DVN	DEVON ENERGY CORP	/etf/ea/ETZCW.djhtm?c=1&etfid=DVN.US&back=QUAL
ITW	ILLINOIS TOOL INC	/etf/ea/ETZCW.djhtm?c=1&etfid=ITW.US&back=QUAL
EL	ESTEE LAUDER INC CLASS A	/etf/ea/ETZCW.djhtm?c=1&etfid=EL.US&back=QUAL
AMD	ADVANCED MICRO DEVICES INC	/etf/ea/ETZCW.djhtm?c=1&etfid=AMD.US&back=QUAL
NUE	NUCOR CORP	/etf/ea/ETZCW.djhtm?c=1&etfid=NUE.US&back=QUAL
ADP	AUTOMATIC DATA PROCESSING INC	/etf/ea/ETZCW.djhtm?c=1&etfid=ADP.US&back=QUAL
AMP	AMERIPRISE FINANCE INC	/etf/ea/ETZCW.djhtm?c=1&etfid=AMP.US&back=QUAL
KMI	KINDER MORGAN INC	/etf/ea/ETZCW.djhtm?c=1&etfid=KMI.US&back=QUAL
TROW	T ROWE PRICE GROUP INC	/etf/ea/ETZCW.djhtm?c=1&etfid=TROW.US&back=QUAL
MMM	3M	/etf/ea/ETZCW.djhtm?c=1&etfid=MMM.US&back=QUAL
INTC	INTEL CORPORATION CORP	/etf/ea/ETZCW.djhtm?c=1&etfid=INTC.US&back=QUAL
NFLX	NETFLIX INC	/etf/ea/ETZCW.djhtm?c=1&etfid=NFLX.US&back=QUAL
AMAT	APPLIED MATERIAL INC	/etf/ea/ETZCW.djhtm?c=1&etfid=AMAT.US&back=QUAL
REGN	REGENERON PHARMACEUTICALS INC	/etf/ea/ETZCW.djhtm?c=1&etfid=REGN.US&back=QUAL
PLD	PROLOGIS REIT INC	/etf/ea/ETZCW.djhtm?c=1&etfid=PLD.US&back=QUAL
ULTA	ULTA BEAUTY INC	/etf/ea/ETZCW.djhtm?c=1&etfid=ULTA.US&back=QUAL
DHI	D R HORTON INC	/etf/ea/ETZCW.djhtm?c=1&etfid=DHI.US&back=QUAL
INTU	INTUIT INC	/etf/ea/ETZCW.djhtm?c=1&etfid=INTU.US&back=QUAL
ZTS	ZOETIS INC CLASS A	/etf/ea/ETZCW.djhtm?c=1&etfid=ZTS.US&back=QUAL
CTRA	COTERRA ENERGY INC	/etf/ea/ETZCW.djhtm?c=1&etfid=CTRA.US&back=QUAL
LYB	LYONDELLBASELL INDUSTRIES NV CLASS	/etf/ea/ETZCW.djhtm?c=1&etfid=LYB.US&back=QUAL
LRCX	LAM RESEARCH CORP	/etf/ea/ETZCW.djhtm?c=1&etfid=LRCX.US&back=QUAL
HSY	HERSHEY FOODS	/etf/ea/ETZCW.djhtm?c=1&etfid=HSY.US&back=QUAL
BBY	BEST BUY INC	/etf/ea/ETZCW.djhtm?c=1&etfid=BBY.US&back=QUAL
TSCO	TRACTOR SUPPLY	/etf/ea/ETZCW.djhtm?c=1&etfid=TSCO.US&back=QUAL
PSA	PUBLIC STORAGE REIT	/etf/ea/ETZCW.djhtm?c=1&etfid=PSA.US&back=QUAL
VRTX	VERTEX PHARMACEUTICALS INC	/etf/ea/ETZCW.djhtm?c=1&etfid=VRTX.US&back=QUAL
KLAC	KLA CORP	/etf/ea/ETZCW.djhtm?c=1&etfid=KLAC.US&back=QUAL
EW	EDWARDS LIFESCIENCES CORP	/etf/ea/ETZCW.djhtm?c=1&etfid=EW.US&back=QUAL
CTAS	CINTAS CORP	/etf/ea/ETZCW.djhtm?c=1&etfid=CTAS.US&back=QUAL
ATVI	ACTIVISION BLIZZARD INC	/etf/ea/ETZCW.djhtm?c=1&etfid=ATVI.US&back=QUAL
FDS	FACTSET RESEARCH SYSTEMS INC	/etf/ea/ETZCW.djhtm?c=1&etfid=FDS.US&back=QUAL
POOL	POOL CORP	/etf/ea/ETZCW.djhtm?c=1&etfid=POOL.US&back=QUAL
CLF	CLEVELAND CLIFFS INC	/etf/ea/ETZCW.djhtm?c=1&etfid=CLF.US&back=QUAL
IDXX	IDEXX LABORATORIES INC	/etf/ea/ETZCW.djhtm?c=1&etfid=IDXX.US&back=QUAL
NVR	NVR INC	/etf/ea/ETZCW.djhtm?c=1&etfid=NVR.US&back=QUAL
FAST	FASTENAL	/etf/ea/ETZCW.djhtm?c=1&etfid=FAST.US&back=QUAL
COIN	COINBASE GLOBAL INC CLASS A	/etf/ea/ETZCW.djhtm?c=1&etfid=COIN.US&back=QUAL
MNST	MONSTER BEVERAGE CORP	/etf/ea/ETZCW.djhtm?c=1&etfid=MNST.US&back=QUAL
STLD	STEEL DYNAMICS INC	/etf/ea/ETZCW.djhtm?c=1&etfid=STLD.US&back=QUAL
GWW	WW GRAINGER INC	/etf/ea/ETZCW.djhtm?c=1&etfid=GWW.US&back=QUAL
GRMN	GARMIN LTD	/etf/ea/ETZCW.djhtm?c=1&etfid=GRMN.US&back=QUAL
CE	CELANESE CORP	/etf/ea/ETZCW.djhtm?c=1&etfid=CE.US&back=QUAL
ODFL	OLD DOMINION FREIGHT LINE INC	/etf/ea/ETZCW.djhtm?c=1&etfid=ODFL.US&back=QUAL
CPRT	COPART INC	/etf/ea/ETZCW.djhtm?c=1&etfid=CPRT.US&back=QUAL
CDNS	CADENCE DESIGN SYSTEMS INC	/etf/ea/ETZCW.djhtm?c=1&etfid=CDNS.US&back=QUAL
PAYX	PAYCHEX INC	/etf/ea/ETZCW.djhtm?c=1&etfid=PAYX.US&back=QUAL
ETSY	ETSY INC	/etf/ea/ETZCW.djhtm?c=1&etfid=ETSY.US&back=QUAL
A	AGILENT TECHNOLOGIES INC	/etf/ea/ETZCW.djhtm?c=1&etfid=A.US&back=QUAL
CBRE	CBRE GROUP INC CLASS A	/etf/ea/ETZCW.djhtm?c=1&etfid=CBRE.US&back=QUAL
PHM	PULTEGROUP INC	/etf/ea/ETZCW.djhtm?c=1&etfid=PHM.US&back=QUAL
O	REALTY INCOME REIT CORP	/etf/ea/ETZCW.djhtm?c=1&etfid=O.US&back=QUAL
EXPD	EXPEDITORS INTERNATIONAL OF WASHIN	/etf/ea/ETZCW.djhtm?c=1&etfid=EXPD.US&back=QUAL
FTNT	FORTINET INC	/etf/ea/ETZCW.djhtm?c=1&etfid=FTNT.US&back=QUAL
VICI	VICI PPTYS INC	/etf/ea/ETZCW.djhtm?c=1&etfid=VICI.US&back=QUAL
FNF	FIDELITY NATIONAL FINANCIAL INC	/etf/ea/ETZCW.djhtm?c=1&etfid=FNF.US&back=QUAL
MKTX	MARKETAXESS HOLDINGS INC	/etf/ea/ETZCW.djhtm?c=1&etfid=MKTX.US&back=QUAL
EA	ELECTRONIC ARTS INC	/etf/ea/ETZCW.djhtm?c=1&etfid=EA.US&back=QUAL
WY	WEYERHAEUSER REIT	/etf/ea/ETZCW.djhtm?c=1&etfid=WY.US&back=QUAL
	BLK CSH FND TREASURY SL AGENCY	
EQR	EQUITY RESIDENTIAL REIT	/etf/ea/ETZCW.djhtm?c=1&etfid=EQR.US&back=QUAL
TSN	TYSON FOODS INC CLASS A	/etf/ea/ETZCW.djhtm?c=1&etfid=TSN.US&back=QUAL
VEEV	VEEVA SYSTEMS INC CLASS A	/etf/ea/ETZCW.djhtm?c=1&etfid=VEEV.US&back=QUAL
WST	WEST PHARMACEUTICAL SERVICES INC	/etf/ea/ETZCW.djhtm?c=1&etfid=WST.US&back=QUAL
BF.B	BROWN FORMAN CORP CLASS B	/etf/ea/ETZCW.djhtm?c=1&etfid=BF.B.US&back=QUAL
AVB	AVALONBAY COMMUNITIES REIT INC	/etf/ea/ETZCW.djhtm?c=1&etfid=AVB.US&back=QUAL
CHD	CHURCH AND DWIGHT INC	/etf/ea/ETZCW.djhtm?c=1&etfid=CHD.US&back=QUAL
SEIC	SEI INVESTMENTS	/etf/ea/ETZCW.djhtm?c=1&etfid=SEIC.US&back=QUAL
ANET	ARISTA NETWORKS INC	/etf/ea/ETZCW.djhtm?c=1&etfid=ANET.US&back=QUAL
	DUKE REALTY REIT CORP	
CHRW	CH ROBINSON WORLDWIDE INC	/etf/ea/ETZCW.djhtm?c=1&etfid=CHRW.US&back=QUAL
	USD CASH	
GNRC	GENERAC HOLDINGS INC	/etf/ea/ETZCW.djhtm?c=1&etfid=GNRC.US&back=QUAL
TTWO	TAKE TWO INTERACTIVE SOFTWARE INC	/etf/ea/ETZCW.djhtm?c=1&etfid=TTWO.US&back=QUAL
CAH	CARDINAL HEALTH INC	/etf/ea/ETZCW.djhtm?c=1&etfid=CAH.US&back=QUAL
ERIE	ERIE INDEMNITY CLASS A	/etf/ea/ETZCW.djhtm?c=1&etfid=ERIE.US&back=QUAL
HOLX	HOLOGIC INC	/etf/ea/ETZCW.djhtm?c=1&etfid=HOLX.US&back=QUAL
MPWR	MONOLITHIC POWER SYSTEMS INC	/etf/ea/ETZCW.djhtm?c=1&etfid=MPWR.US&back=QUAL
ALLE	ALLEGION PLC	/etf/ea/ETZCW.djhtm?c=1&etfid=ALLE.US&back=QUAL
RHI	ROBERT HALF	/etf/ea/ETZCW.djhtm?c=1&etfid=RHI.US&back=QUAL
DGX	QUEST DIAGNOSTICS INC	/etf/ea/ETZCW.djhtm?c=1&etfid=DGX.US&back=QUAL
MAA	MID AMERICA APARTMENT COMMUNITIES	/etf/ea/ETZCW.djhtm?c=1&etfid=MAA.US&back=QUAL
PAYC	PAYCOM SOFTWARE INC	/etf/ea/ETZCW.djhtm?c=1&etfid=PAYC.US&back=QUAL
ESS	ESSEX PROPERTY TRUST REIT INC	/etf/ea/ETZCW.djhtm?c=1&etfid=ESS.US&back=QUAL
TER	TERADYNE INC	/etf/ea/ETZCW.djhtm?c=1&etfid=TER.US&back=QUAL
OMC	OMNICOM GROUP INC	/etf/ea/ETZCW.djhtm?c=1&etfid=OMC.US&back=QUAL
SWKS	SKYWORKS SOLUTIONS INC	/etf/ea/ETZCW.djhtm?c=1&etfid=SWKS.US&back=QUAL
AOS	A O SMITH CORP	/etf/ea/ETZCW.djhtm?c=1&etfid=AOS.US&back=QUAL
JKHY	JACK HENRY AND ASSOCIATES INC	/etf/ea/ETZCW.djhtm?c=1&etfid=JKHY.US&back=QUAL
ROL	ROLLINS INC	/etf/ea/ETZCW.djhtm?c=1&etfid=ROL.US&back=QUAL
KIM	KIMCO REALTY REIT CORP	/etf/ea/ETZCW.djhtm?c=1&etfid=KIM.US&back=QUAL
ABMD	ABIOMED INC	/etf/ea/ETZCW.djhtm?c=1&etfid=ABMD.US&back=QUAL
IPG	INTERPUBLIC GROUP OF COMPANIES INC	/etf/ea/ETZCW.djhtm?c=1&etfid=IPG.US&back=QUAL
HSIC	HENRY SCHEIN INC	/etf/ea/ETZCW.djhtm?c=1&etfid=HSIC.US&back=QUAL
FOXA	FOX CORP CLASS A	/etf/ea/ETZCW.djhtm?c=1&etfid=FOXA.US&back=QUAL
FOX	FOX CORP CLASS B	/etf/ea/ETZCW.djhtm?c=1&etfid=FOX.US&back=QUAL
	CASH COLLATERAL USD SGAFT	
