REM
NLY	ANNALY CAPITAL MANAGEMENT REIT INC	/etf/ea/ETZCW.djhtm?c=1&etfid=NLY.US&back=REM
STWD	STARWOOD PROPERTY TRUST REIT INC	/etf/ea/ETZCW.djhtm?c=1&etfid=STWD.US&back=REM
AGNC	AGNC INVESTMENT REIT CORP	/etf/ea/ETZCW.djhtm?c=1&etfid=AGNC.US&back=REM
BXMT	BLACKSTONE MORTGAGE TRUST REIT CLA	/etf/ea/ETZCW.djhtm?c=1&etfid=BXMT.US&back=REM
HASI	HANNON ARMSTRONG SUSTAINABLE INFRA	/etf/ea/ETZCW.djhtm?c=1&etfid=HASI.US&back=REM
ABR	ARBOR REALTY TRUST REIT INC	/etf/ea/ETZCW.djhtm?c=1&etfid=ABR.US&back=REM
RITM	RITHM CAPITAL CORP	/etf/ea/ETZCW.djhtm?c=1&etfid=RITM.US&back=REM
CIM	CHIMERA INVESTMENT CORP	/etf/ea/ETZCW.djhtm?c=1&etfid=CIM.US&back=REM
TWO	TWO HARBORS INVESTMENT REIT CORP	/etf/ea/ETZCW.djhtm?c=1&etfid=TWO.US&back=REM
ARI	APOLLO COMMERCIAL REAL ESTATE FINA	/etf/ea/ETZCW.djhtm?c=1&etfid=ARI.US&back=REM
PMT	PENNYMAC MORTGAGE INVESTMENT TRUST	/etf/ea/ETZCW.djhtm?c=1&etfid=PMT.US&back=REM
LADR	LADDER CAPITAL CORP CLASS A	/etf/ea/ETZCW.djhtm?c=1&etfid=LADR.US&back=REM
MFA	MFA FINANCIAL INC	/etf/ea/ETZCW.djhtm?c=1&etfid=MFA.US&back=REM
FBRT	FRANKLIN BSP REALTY TRUST INC	/etf/ea/ETZCW.djhtm?c=1&etfid=FBRT.US&back=REM
NYMT	NEW YORK MORTGAGE TRUST REIT INC	/etf/ea/ETZCW.djhtm?c=1&etfid=NYMT.US&back=REM
KREF	KKR REAL ESTATE FINANCE INC TRUST	/etf/ea/ETZCW.djhtm?c=1&etfid=KREF.US&back=REM
RC	READY CAPITAL CORP	/etf/ea/ETZCW.djhtm?c=1&etfid=RC.US&back=REM
RWT	REDWOOD TRUST REIT INC	/etf/ea/ETZCW.djhtm?c=1&etfid=RWT.US&back=REM
BRMK	BROADMARK REALTY CAPITAL INC	/etf/ea/ETZCW.djhtm?c=1&etfid=BRMK.US&back=REM
EFC	ELLINGTON FINANCIAL INC	/etf/ea/ETZCW.djhtm?c=1&etfid=EFC.US&back=REM
BRSP	BRIGHTSPIRE CAPITAL INC CLASS A	/etf/ea/ETZCW.djhtm?c=1&etfid=BRSP.US&back=REM
ARR	ARMOUR RESIDENTIAL REIT INC	/etf/ea/ETZCW.djhtm?c=1&etfid=ARR.US&back=REM
TRTX	TPG RE FINANCE TRUST INC	/etf/ea/ETZCW.djhtm?c=1&etfid=TRTX.US&back=REM
ACRE	ARES COMMERCIAL REAL ESTATE REIT C	/etf/ea/ETZCW.djhtm?c=1&etfid=ACRE.US&back=REM
DX	DYNEX CAPITAL REIT INC	/etf/ea/ETZCW.djhtm?c=1&etfid=DX.US&back=REM
IVR	INVESCO MORTGAGE CAPITAL REIT INC	/etf/ea/ETZCW.djhtm?c=1&etfid=IVR.US&back=REM
GPMT	GRANITE POINT MORTGAGE TRUST INC	/etf/ea/ETZCW.djhtm?c=1&etfid=GPMT.US&back=REM
ORC	ORCHID ISLAND CAPITAL INC	/etf/ea/ETZCW.djhtm?c=1&etfid=ORC.US&back=REM
AJX	GREAT AJAX CORP	/etf/ea/ETZCW.djhtm?c=1&etfid=AJX.US&back=REM
AOMR	ANGEL OAK MORTGAGE INC	/etf/ea/ETZCW.djhtm?c=1&etfid=AOMR.US&back=REM
MITT	AG MORTGAGE INVESTMENT TRUST REIT	/etf/ea/ETZCW.djhtm?c=1&etfid=MITT.US&back=REM
	BLK CSH FND TREASURY SL AGENCY	
	USD CASH	
	CASH COLLATERAL USD MLPFT	
