RFV
UNM	Unum Group	/etf/ea/ETZCW.djhtm?c=1&etfid=UNM.US&back=RFV
DINO	HF Sinclair Corp	/etf/ea/ETZCW.djhtm?c=1&etfid=DINO.US&back=RFV
RGA	Reinsurance Group of America Inc	/etf/ea/ETZCW.djhtm?c=1&etfid=RGA.US&back=RFV
AVT	Avnet Inc	/etf/ea/ETZCW.djhtm?c=1&etfid=AVT.US&back=RFV
Y	Alleghany Corp	/etf/ea/ETZCW.djhtm?c=1&etfid=Y.US&back=RFV
X	United States Steel Corp	/etf/ea/ETZCW.djhtm?c=1&etfid=X.US&back=RFV
CMC	Commercial Metals Co	/etf/ea/ETZCW.djhtm?c=1&etfid=CMC.US&back=RFV
GHC	Graham Holdings Co	/etf/ea/ETZCW.djhtm?c=1&etfid=GHC.US&back=RFV
CNO	CNO Financial Group Inc	/etf/ea/ETZCW.djhtm?c=1&etfid=CNO.US&back=RFV
R	Ryder System Inc	/etf/ea/ETZCW.djhtm?c=1&etfid=R.US&back=RFV
XRX	Xerox Holdings Corp	/etf/ea/ETZCW.djhtm?c=1&etfid=XRX.US&back=RFV
TMHC	Taylor Morrison Home Corp	/etf/ea/ETZCW.djhtm?c=1&etfid=TMHC.US&back=RFV
KMPR	Kemper Corp	/etf/ea/ETZCW.djhtm?c=1&etfid=KMPR.US&back=RFV
MUSA	Murphy USA Inc	/etf/ea/ETZCW.djhtm?c=1&etfid=MUSA.US&back=RFV
VOYA	Voya Financial Inc	/etf/ea/ETZCW.djhtm?c=1&etfid=VOYA.US&back=RFV
RS	Reliance Steel & Aluminum Co	/etf/ea/ETZCW.djhtm?c=1&etfid=RS.US&back=RFV
ORI	Old Republic International Corp	/etf/ea/ETZCW.djhtm?c=1&etfid=ORI.US&back=RFV
GEF	Greif Inc	/etf/ea/ETZCW.djhtm?c=1&etfid=GEF.US&back=RFV
SFM	Sprouts Farmers Market Inc	/etf/ea/ETZCW.djhtm?c=1&etfid=SFM.US&back=RFV
FL	Foot Locker Inc	/etf/ea/ETZCW.djhtm?c=1&etfid=FL.US&back=RFV
ARW	Arrow Electronics Inc	/etf/ea/ETZCW.djhtm?c=1&etfid=ARW.US&back=RFV
LAD	Lithia Motors Inc	/etf/ea/ETZCW.djhtm?c=1&etfid=LAD.US&back=RFV
FHN	First Horizon Corp	/etf/ea/ETZCW.djhtm?c=1&etfid=FHN.US&back=RFV
THG	Hanover Insurance Group Inc/The	/etf/ea/ETZCW.djhtm?c=1&etfid=THG.US&back=RFV
NOV	NOV Inc	/etf/ea/ETZCW.djhtm?c=1&etfid=NOV.US&back=RFV
PFGC	Performance Food Group Co	/etf/ea/ETZCW.djhtm?c=1&etfid=PFGC.US&back=RFV
UNVR	Univar Solutions Inc	/etf/ea/ETZCW.djhtm?c=1&etfid=UNVR.US&back=RFV
SNX	TD SYNNEX Corp	/etf/ea/ETZCW.djhtm?c=1&etfid=SNX.US&back=RFV
THO	Thor Industries Inc	/etf/ea/ETZCW.djhtm?c=1&etfid=THO.US&back=RFV
ADNT	Adient PLC	/etf/ea/ETZCW.djhtm?c=1&etfid=ADNT.US&back=RFV
FNB	FNB Corp/PA	/etf/ea/ETZCW.djhtm?c=1&etfid=FNB.US&back=RFV
MAN	ManpowerGroup Inc	/etf/ea/ETZCW.djhtm?c=1&etfid=MAN.US&back=RFV
KBH	KB Home	/etf/ea/ETZCW.djhtm?c=1&etfid=KBH.US&back=RFV
FULT	Fulton Financial Corp	/etf/ea/ETZCW.djhtm?c=1&etfid=FULT.US&back=RFV
ASB	Associated Banc-Corp	/etf/ea/ETZCW.djhtm?c=1&etfid=ASB.US&back=RFV
PRGO	Perrigo Co PLC	/etf/ea/ETZCW.djhtm?c=1&etfid=PRGO.US&back=RFV
WOR	Worthington Industries Inc	/etf/ea/ETZCW.djhtm?c=1&etfid=WOR.US&back=RFV
KSS	Kohl's Corp	/etf/ea/ETZCW.djhtm?c=1&etfid=KSS.US&back=RFV
MTG	MGIC Investment Corp	/etf/ea/ETZCW.djhtm?c=1&etfid=MTG.US&back=RFV
TCBI	Texas Capital Bancshares Inc	/etf/ea/ETZCW.djhtm?c=1&etfid=TCBI.US&back=RFV
SWX	Southwest Gas Holdings Inc	/etf/ea/ETZCW.djhtm?c=1&etfid=SWX.US&back=RFV
PDCO	Patterson Cos Inc	/etf/ea/ETZCW.djhtm?c=1&etfid=PDCO.US&back=RFV
PVH	PVH Corp	/etf/ea/ETZCW.djhtm?c=1&etfid=PVH.US&back=RFV
SR	Spire Inc	/etf/ea/ETZCW.djhtm?c=1&etfid=SR.US&back=RFV
LEA	Lear Corp	/etf/ea/ETZCW.djhtm?c=1&etfid=LEA.US&back=RFV
GT	Goodyear Tire & Rubber Co/The	/etf/ea/ETZCW.djhtm?c=1&etfid=GT.US&back=RFV
PPC	Pilgrim's Pride Corp	/etf/ea/ETZCW.djhtm?c=1&etfid=PPC.US&back=RFV
FLR	Fluor Corp	/etf/ea/ETZCW.djhtm?c=1&etfid=FLR.US&back=RFV
MDU	MDU Resources Group Inc	/etf/ea/ETZCW.djhtm?c=1&etfid=MDU.US&back=RFV
NLY	Annaly Capital Management Inc	/etf/ea/ETZCW.djhtm?c=1&etfid=NLY.US&back=RFV
DAN	Dana Inc	/etf/ea/ETZCW.djhtm?c=1&etfid=DAN.US&back=RFV
GPS	Gap Inc/The	/etf/ea/ETZCW.djhtm?c=1&etfid=GPS.US&back=RFV
SAIC	Science Applications International Corp	/etf/ea/ETZCW.djhtm?c=1&etfid=SAIC.US&back=RFV
VSH	Vishay Intertechnology Inc	/etf/ea/ETZCW.djhtm?c=1&etfid=VSH.US&back=RFV
UBSI	United Bankshares Inc/WV	/etf/ea/ETZCW.djhtm?c=1&etfid=UBSI.US&back=RFV
M	Macy's Inc	/etf/ea/ETZCW.djhtm?c=1&etfid=M.US&back=RFV
CADE	Cadence Bank	/etf/ea/ETZCW.djhtm?c=1&etfid=CADE.US&back=RFV
NYCB	New York Community Bancorp Inc	/etf/ea/ETZCW.djhtm?c=1&etfid=NYCB.US&back=RFV
SIGI	Selective Insurance Group Inc	/etf/ea/ETZCW.djhtm?c=1&etfid=SIGI.US&back=RFV
EME	EMCOR Group Inc	/etf/ea/ETZCW.djhtm?c=1&etfid=EME.US&back=RFV
PB	Prosperity Bancshares Inc	/etf/ea/ETZCW.djhtm?c=1&etfid=PB.US&back=RFV
ONB	Old National Bancorp/IN	/etf/ea/ETZCW.djhtm?c=1&etfid=ONB.US&back=RFV
AGCO	AGCO Corp	/etf/ea/ETZCW.djhtm?c=1&etfid=AGCO.US&back=RFV
UGI	UGI Corp	/etf/ea/ETZCW.djhtm?c=1&etfid=UGI.US&back=RFV
NUS	Nu Skin Enterprises Inc	/etf/ea/ETZCW.djhtm?c=1&etfid=NUS.US&back=RFV
IBOC	International Bancshares Corp	/etf/ea/ETZCW.djhtm?c=1&etfid=IBOC.US&back=RFV
ESNT	Essent Group Ltd	/etf/ea/ETZCW.djhtm?c=1&etfid=ESNT.US&back=RFV
BJ	BJ's Wholesale Club Holdings Inc	/etf/ea/ETZCW.djhtm?c=1&etfid=BJ.US&back=RFV
CBT	Cabot Corp	/etf/ea/ETZCW.djhtm?c=1&etfid=CBT.US&back=RFV
OC	Owens Corning	/etf/ea/ETZCW.djhtm?c=1&etfid=OC.US&back=RFV
TOL	Toll Brothers Inc	/etf/ea/ETZCW.djhtm?c=1&etfid=TOL.US&back=RFV
BFH	Bread Financial Holdings Inc	/etf/ea/ETZCW.djhtm?c=1&etfid=BFH.US&back=RFV
MODG	Topgolf Callaway Brands Corp	/etf/ea/ETZCW.djhtm?c=1&etfid=MODG.US&back=RFV
NWE	NorthWestern Corp	/etf/ea/ETZCW.djhtm?c=1&etfid=NWE.US&back=RFV
KEX	Kirby Corp	/etf/ea/ETZCW.djhtm?c=1&etfid=KEX.US&back=RFV
RNR	RenaissanceRe Holdings Ltd	/etf/ea/ETZCW.djhtm?c=1&etfid=RNR.US&back=RFV
SLGN	Silgan Holdings Inc	/etf/ea/ETZCW.djhtm?c=1&etfid=SLGN.US&back=RFV
WAFD	Washington Federal Inc	/etf/ea/ETZCW.djhtm?c=1&etfid=WAFD.US&back=RFV
CACI	CACI International Inc	/etf/ea/ETZCW.djhtm?c=1&etfid=CACI.US&back=RFV
SLG	SL Green Realty Corp	/etf/ea/ETZCW.djhtm?c=1&etfid=SLG.US&back=RFV
VSAT	Viasat Inc	/etf/ea/ETZCW.djhtm?c=1&etfid=VSAT.US&back=RFV
SBRA	Sabra Health Care REIT Inc	/etf/ea/ETZCW.djhtm?c=1&etfid=SBRA.US&back=RFV
INGR	Ingredion Inc	/etf/ea/ETZCW.djhtm?c=1&etfid=INGR.US&back=RFV
JWN	Nordstrom Inc	/etf/ea/ETZCW.djhtm?c=1&etfid=JWN.US&back=RFV
VLY	Valley National Bancorp	/etf/ea/ETZCW.djhtm?c=1&etfid=VLY.US&back=RFV
POR	Portland General Electric Co	/etf/ea/ETZCW.djhtm?c=1&etfid=POR.US&back=RFV
OGS	ONE Gas Inc	/etf/ea/ETZCW.djhtm?c=1&etfid=OGS.US&back=RFV
XPO	XPO Logistics Inc	/etf/ea/ETZCW.djhtm?c=1&etfid=XPO.US&back=RFV
KNX	Knight-Swift Transportation Holdings Inc	/etf/ea/ETZCW.djhtm?c=1&etfid=KNX.US&back=RFV
ENS	EnerSys	/etf/ea/ETZCW.djhtm?c=1&etfid=ENS.US&back=RFV
HOG	Harley-Davidson Inc	/etf/ea/ETZCW.djhtm?c=1&etfid=HOG.US&back=RFV
ALE	ALLETE Inc	/etf/ea/ETZCW.djhtm?c=1&etfid=ALE.US&back=RFV
JBLU	JetBlue Airways Corp	/etf/ea/ETZCW.djhtm?c=1&etfid=JBLU.US&back=RFV
TEX	Terex Corp	/etf/ea/ETZCW.djhtm?c=1&etfid=TEX.US&back=RFV
HE	Hawaiian Electric Industries Inc	/etf/ea/ETZCW.djhtm?c=1&etfid=HE.US&back=RFV
ETRN	Equitrans Midstream Corp	/etf/ea/ETZCW.djhtm?c=1&etfid=ETRN.US&back=RFV
OSK	Oshkosh Corp	/etf/ea/ETZCW.djhtm?c=1&etfid=OSK.US&back=RFV
WERN	Werner Enterprises Inc	/etf/ea/ETZCW.djhtm?c=1&etfid=WERN.US&back=RFV
KD	Kyndryl Holdings Inc	/etf/ea/ETZCW.djhtm?c=1&etfid=KD.US&back=RFV
TKR	Timken Co/The	/etf/ea/ETZCW.djhtm?c=1&etfid=TKR.US&back=RFV
CC	Chemours Co/The	/etf/ea/ETZCW.djhtm?c=1&etfid=CC.US&back=RFV
MLKN	MillerKnoll Inc	/etf/ea/ETZCW.djhtm?c=1&etfid=MLKN.US&back=RFV
