ROUS
PFE	PFIZER INC COMMON STOCK USD.05	/etf/ea/ETZCW.djhtm?c=1&etfid=PFE.US&back=ROUS
MUSA	MURPHY USA INC COMMON STOCK	/etf/ea/ETZCW.djhtm?c=1&etfid=MUSA.US&back=ROUS
VZ	VERIZON COMMUNICATIONS INC COMMON STOCK USD.1	/etf/ea/ETZCW.djhtm?c=1&etfid=VZ.US&back=ROUS
JNJ	JOHNSON + JOHNSON COMMON STOCK USD1.0	/etf/ea/ETZCW.djhtm?c=1&etfid=JNJ.US&back=ROUS
ACN	ACCENTURE PLC CL A COMMON STOCK USD.0000225	/etf/ea/ETZCW.djhtm?c=1&etfid=ACN.US&back=ROUS
AAPL	APPLE INC COMMON STOCK USD.00001	/etf/ea/ETZCW.djhtm?c=1&etfid=AAPL.US&back=ROUS
MSFT	MICROSOFT CORP COMMON STOCK USD.00000625	/etf/ea/ETZCW.djhtm?c=1&etfid=MSFT.US&back=ROUS
CSCO	CISCO SYSTEMS INC COMMON STOCK USD.001	/etf/ea/ETZCW.djhtm?c=1&etfid=CSCO.US&back=ROUS
COST	COSTCO WHOLESALE CORP COMMON STOCK USD.005	/etf/ea/ETZCW.djhtm?c=1&etfid=COST.US&back=ROUS
HD	HOME DEPOT INC COMMON STOCK USD.05	/etf/ea/ETZCW.djhtm?c=1&etfid=HD.US&back=ROUS
UNH	UNITEDHEALTH GROUP INC COMMON STOCK USD.01	/etf/ea/ETZCW.djhtm?c=1&etfid=UNH.US&back=ROUS
TMO	THERMO FISHER SCIENTIFIC INC COMMON STOCK USD1.0	/etf/ea/ETZCW.djhtm?c=1&etfid=TMO.US&back=ROUS
HRB	H+R BLOCK INC COMMON STOCK	/etf/ea/ETZCW.djhtm?c=1&etfid=HRB.US&back=ROUS
PEP	PEPSICO INC COMMON STOCK USD.017	/etf/ea/ETZCW.djhtm?c=1&etfid=PEP.US&back=ROUS
BRK.B	BERKSHIRE HATHAWAY INC CL B COMMON STOCK USD.0033	/etf/ea/ETZCW.djhtm?c=1&etfid=BRK.B.US&back=ROUS
GILD	GILEAD SCIENCES INC COMMON STOCK USD.001	/etf/ea/ETZCW.djhtm?c=1&etfid=GILD.US&back=ROUS
ABBV	ABBVIE INC COMMON STOCK USD.01	/etf/ea/ETZCW.djhtm?c=1&etfid=ABBV.US&back=ROUS
ABT	ABBOTT LABORATORIES COMMON STOCK	/etf/ea/ETZCW.djhtm?c=1&etfid=ABT.US&back=ROUS
PG	PROCTER + GAMBLE CO/THE COMMON STOCK	/etf/ea/ETZCW.djhtm?c=1&etfid=PG.US&back=ROUS
HPQ	HP INC COMMON STOCK USD.01	/etf/ea/ETZCW.djhtm?c=1&etfid=HPQ.US&back=ROUS
GOOGL	ALPHABET INC CL A COMMON STOCK USD.001	/etf/ea/ETZCW.djhtm?c=1&etfid=GOOGL.US&back=ROUS
JPM	JPMORGAN CHASE + CO COMMON STOCK USD1.0	/etf/ea/ETZCW.djhtm?c=1&etfid=JPM.US&back=ROUS
NOC	NORTHROP GRUMMAN CORP COMMON STOCK USD1.0	/etf/ea/ETZCW.djhtm?c=1&etfid=NOC.US&back=ROUS
CVX	CHEVRON CORP COMMON STOCK USD.75	/etf/ea/ETZCW.djhtm?c=1&etfid=CVX.US&back=ROUS
DG	DOLLAR GENERAL CORP COMMON STOCK USD.875	/etf/ea/ETZCW.djhtm?c=1&etfid=DG.US&back=ROUS
AMZN	AMAZON.COM INC COMMON STOCK USD.01	/etf/ea/ETZCW.djhtm?c=1&etfid=AMZN.US&back=ROUS
ADBE	ADOBE INC COMMON STOCK USD.0001	/etf/ea/ETZCW.djhtm?c=1&etfid=ADBE.US&back=ROUS
DGX	QUEST DIAGNOSTICS INC COMMON STOCK USD.01	/etf/ea/ETZCW.djhtm?c=1&etfid=DGX.US&back=ROUS
ORCL	ORACLE CORP COMMON STOCK USD.01	/etf/ea/ETZCW.djhtm?c=1&etfid=ORCL.US&back=ROUS
KR	KROGER CO COMMON STOCK USD1.0	/etf/ea/ETZCW.djhtm?c=1&etfid=KR.US&back=ROUS
MSI	MOTOROLA SOLUTIONS INC COMMON STOCK USD.01	/etf/ea/ETZCW.djhtm?c=1&etfid=MSI.US&back=ROUS
CHRW	C.H. ROBINSON WORLDWIDE INC COMMON STOCK USD.1	/etf/ea/ETZCW.djhtm?c=1&etfid=CHRW.US&back=ROUS
AVGO	BROADCOM INC COMMON STOCK	/etf/ea/ETZCW.djhtm?c=1&etfid=AVGO.US&back=ROUS
CMCSA	COMCAST CORP CLASS A COMMON STOCK USD.01	/etf/ea/ETZCW.djhtm?c=1&etfid=CMCSA.US&back=ROUS
META	META PLATFORMS INC CLASS A COMMON STOCK USD.000006	/etf/ea/ETZCW.djhtm?c=1&etfid=META.US&back=ROUS
V	VISA INC CLASS A SHARES COMMON STOCK USD.0001	/etf/ea/ETZCW.djhtm?c=1&etfid=V.US&back=ROUS
REGN	REGENERON PHARMACEUTICALS COMMON STOCK USD.001	/etf/ea/ETZCW.djhtm?c=1&etfid=REGN.US&back=ROUS
CVS	CVS HEALTH CORP COMMON STOCK USD.01	/etf/ea/ETZCW.djhtm?c=1&etfid=CVS.US&back=ROUS
DPZ	DOMINO S PIZZA INC COMMON STOCK USD.01	/etf/ea/ETZCW.djhtm?c=1&etfid=DPZ.US&back=ROUS
BR	BROADRIDGE FINANCIAL SOLUTIO COMMON STOCK USD.01	/etf/ea/ETZCW.djhtm?c=1&etfid=BR.US&back=ROUS
IBM	INTL BUSINESS MACHINES CORP COMMON STOCK USD.2	/etf/ea/ETZCW.djhtm?c=1&etfid=IBM.US&back=ROUS
STX	SEAGATE TECHNOLOGY HOLDINGS COMMON STOCK USD.00001	/etf/ea/ETZCW.djhtm?c=1&etfid=STX.US&back=ROUS
XOM	EXXON MOBIL CORP COMMON STOCK	/etf/ea/ETZCW.djhtm?c=1&etfid=XOM.US&back=ROUS
LLY	ELI LILLY + CO COMMON STOCK	/etf/ea/ETZCW.djhtm?c=1&etfid=LLY.US&back=ROUS
JKHY	JACK HENRY + ASSOCIATES INC COMMON STOCK USD.01	/etf/ea/ETZCW.djhtm?c=1&etfid=JKHY.US&back=ROUS
KO	COCA COLA CO/THE COMMON STOCK USD.25	/etf/ea/ETZCW.djhtm?c=1&etfid=KO.US&back=ROUS
PAYX	PAYCHEX INC COMMON STOCK USD.01	/etf/ea/ETZCW.djhtm?c=1&etfid=PAYX.US&back=ROUS
ABC	AMERISOURCEBERGEN CORP COMMON STOCK USD.01	/etf/ea/ETZCW.djhtm?c=1&etfid=ABC.US&back=ROUS
TGT	TARGET CORP COMMON STOCK USD.0833	/etf/ea/ETZCW.djhtm?c=1&etfid=TGT.US&back=ROUS
TSCO	TRACTOR SUPPLY COMPANY COMMON STOCK USD.008	/etf/ea/ETZCW.djhtm?c=1&etfid=TSCO.US&back=ROUS
ED	CONSOLIDATED EDISON INC COMMON STOCK USD.1	/etf/ea/ETZCW.djhtm?c=1&etfid=ED.US&back=ROUS
MA	MASTERCARD INC   A COMMON STOCK USD.0001	/etf/ea/ETZCW.djhtm?c=1&etfid=MA.US&back=ROUS
LSTR	LANDSTAR SYSTEM INC COMMON STOCK USD.01	/etf/ea/ETZCW.djhtm?c=1&etfid=LSTR.US&back=ROUS
AZO	AUTOZONE INC COMMON STOCK USD.01	/etf/ea/ETZCW.djhtm?c=1&etfid=AZO.US&back=ROUS
BAC	BANK OF AMERICA CORP COMMON STOCK USD.01	/etf/ea/ETZCW.djhtm?c=1&etfid=BAC.US&back=ROUS
GPC	GENUINE PARTS CO COMMON STOCK USD1.0	/etf/ea/ETZCW.djhtm?c=1&etfid=GPC.US&back=ROUS
ORLY	O REILLY AUTOMOTIVE INC COMMON STOCK USD.01	/etf/ea/ETZCW.djhtm?c=1&etfid=ORLY.US&back=ROUS
NTAP	NETAPP INC COMMON STOCK USD.001	/etf/ea/ETZCW.djhtm?c=1&etfid=NTAP.US&back=ROUS
PINC	PREMIER INC CLASS A COMMON STOCK USD.01	/etf/ea/ETZCW.djhtm?c=1&etfid=PINC.US&back=ROUS
EXPD	EXPEDITORS INTL WASH INC COMMON STOCK USD.01	/etf/ea/ETZCW.djhtm?c=1&etfid=EXPD.US&back=ROUS
	CITRIX SYSTEMS INC COMMON STOCK USD.001	
WM	WASTE MANAGEMENT INC COMMON STOCK USD.01	/etf/ea/ETZCW.djhtm?c=1&etfid=WM.US&back=ROUS
WU	WESTERN UNION CO COMMON STOCK USD.01	/etf/ea/ETZCW.djhtm?c=1&etfid=WU.US&back=ROUS
KEYS	KEYSIGHT TECHNOLOGIES IN COMMON STOCK	/etf/ea/ETZCW.djhtm?c=1&etfid=KEYS.US&back=ROUS
HPE	HEWLETT PACKARD ENTERPRISE COMMON STOCK USD.01	/etf/ea/ETZCW.djhtm?c=1&etfid=HPE.US&back=ROUS
NUE	NUCOR CORP COMMON STOCK USD.4	/etf/ea/ETZCW.djhtm?c=1&etfid=NUE.US&back=ROUS
FCN	FTI CONSULTING INC COMMON STOCK USD.01	/etf/ea/ETZCW.djhtm?c=1&etfid=FCN.US&back=ROUS
RS	RELIANCE STEEL + ALUMINUM COMMON STOCK	/etf/ea/ETZCW.djhtm?c=1&etfid=RS.US&back=ROUS
TGNA	TEGNA INC COMMON STOCK USD1.0	/etf/ea/ETZCW.djhtm?c=1&etfid=TGNA.US&back=ROUS
WSO	WATSCO INC COMMON STOCK USD.5	/etf/ea/ETZCW.djhtm?c=1&etfid=WSO.US&back=ROUS
TXN	TEXAS INSTRUMENTS INC COMMON STOCK USD1.0	/etf/ea/ETZCW.djhtm?c=1&etfid=TXN.US&back=ROUS
AKAM	AKAMAI TECHNOLOGIES INC COMMON STOCK USD.01	/etf/ea/ETZCW.djhtm?c=1&etfid=AKAM.US&back=ROUS
NFG	NATIONAL FUEL GAS CO COMMON STOCK USD1.0	/etf/ea/ETZCW.djhtm?c=1&etfid=NFG.US&back=ROUS
MRK	MERCK + CO. INC. COMMON STOCK USD.5	/etf/ea/ETZCW.djhtm?c=1&etfid=MRK.US&back=ROUS
PSA	PUBLIC STORAGE REIT USD.1	/etf/ea/ETZCW.djhtm?c=1&etfid=PSA.US&back=ROUS
LMT	LOCKHEED MARTIN CORP COMMON STOCK USD1.0	/etf/ea/ETZCW.djhtm?c=1&etfid=LMT.US&back=ROUS
ALL	ALLSTATE CORP COMMON STOCK USD.01	/etf/ea/ETZCW.djhtm?c=1&etfid=ALL.US&back=ROUS
ADP	AUTOMATIC DATA PROCESSING COMMON STOCK USD.1	/etf/ea/ETZCW.djhtm?c=1&etfid=ADP.US&back=ROUS
BAH	BOOZ ALLEN HAMILTON HOLDINGS COMMON STOCK USD.01	/etf/ea/ETZCW.djhtm?c=1&etfid=BAH.US&back=ROUS
BJ	BJ S WHOLESALE CLUB HOLDINGS COMMON STOCK USD.01	/etf/ea/ETZCW.djhtm?c=1&etfid=BJ.US&back=ROUS
FLO	FLOWERS FOODS INC COMMON STOCK USD.01	/etf/ea/ETZCW.djhtm?c=1&etfid=FLO.US&back=ROUS
CTRA	COTERRA ENERGY INC COMMON STOCK USD.1	/etf/ea/ETZCW.djhtm?c=1&etfid=CTRA.US&back=ROUS
CRM	SALESFORCE INC COMMON STOCK USD.001	/etf/ea/ETZCW.djhtm?c=1&etfid=CRM.US&back=ROUS
DELL	DELL TECHNOLOGIES  C COMMON STOCK	/etf/ea/ETZCW.djhtm?c=1&etfid=DELL.US&back=ROUS
FAST	FASTENAL CO COMMON STOCK USD.01	/etf/ea/ETZCW.djhtm?c=1&etfid=FAST.US&back=ROUS
VRSN	VERISIGN INC COMMON STOCK USD.001	/etf/ea/ETZCW.djhtm?c=1&etfid=VRSN.US&back=ROUS
RSG	REPUBLIC SERVICES INC COMMON STOCK USD.01	/etf/ea/ETZCW.djhtm?c=1&etfid=RSG.US&back=ROUS
UPS	UNITED PARCEL SERVICE CL B COMMON STOCK USD.01	/etf/ea/ETZCW.djhtm?c=1&etfid=UPS.US&back=ROUS
EXR	EXTRA SPACE STORAGE INC REIT USD.01	/etf/ea/ETZCW.djhtm?c=1&etfid=EXR.US&back=ROUS
	US DOLLAR	
AMGN	AMGEN INC COMMON STOCK USD.0001	/etf/ea/ETZCW.djhtm?c=1&etfid=AMGN.US&back=ROUS
GWW	WW GRAINGER INC COMMON STOCK USD.5	/etf/ea/ETZCW.djhtm?c=1&etfid=GWW.US&back=ROUS
INTU	INTUIT INC COMMON STOCK USD.01	/etf/ea/ETZCW.djhtm?c=1&etfid=INTU.US&back=ROUS
POOL	POOL CORP COMMON STOCK USD.001	/etf/ea/ETZCW.djhtm?c=1&etfid=POOL.US&back=ROUS
PGR	PROGRESSIVE CORP COMMON STOCK USD1.0	/etf/ea/ETZCW.djhtm?c=1&etfid=PGR.US&back=ROUS
NVDA	NVIDIA CORP COMMON STOCK USD.001	/etf/ea/ETZCW.djhtm?c=1&etfid=NVDA.US&back=ROUS
AMN	AMN HEALTHCARE SERVICES INC COMMON STOCK USD.01	/etf/ea/ETZCW.djhtm?c=1&etfid=AMN.US&back=ROUS
	ELEVANCE HEALTH INC COMMON STOCK USD.01	
VNT	VONTIER CORP COMMON STOCK USD.0001	/etf/ea/ETZCW.djhtm?c=1&etfid=VNT.US&back=ROUS
BBY	BEST BUY CO INC COMMON STOCK USD.1	/etf/ea/ETZCW.djhtm?c=1&etfid=BBY.US&back=ROUS
DLB	DOLBY LABORATORIES INC CL A COMMON STOCK USD.001	/etf/ea/ETZCW.djhtm?c=1&etfid=DLB.US&back=ROUS
NLOK	NORTONLIFELOCK INC COMMON STOCK USD.01	/etf/ea/ETZCW.djhtm?c=1&etfid=NLOK.US&back=ROUS
INTC	INTEL CORP COMMON STOCK USD.001	/etf/ea/ETZCW.djhtm?c=1&etfid=INTC.US&back=ROUS
JNPR	JUNIPER NETWORKS INC COMMON STOCK USD.00001	/etf/ea/ETZCW.djhtm?c=1&etfid=JNPR.US&back=ROUS
DLR	DIGITAL REALTY TRUST INC REIT USD.01	/etf/ea/ETZCW.djhtm?c=1&etfid=DLR.US&back=ROUS
CDW	CDW CORP/DE COMMON STOCK USD.01	/etf/ea/ETZCW.djhtm?c=1&etfid=CDW.US&back=ROUS
CAH	CARDINAL HEALTH INC COMMON STOCK	/etf/ea/ETZCW.djhtm?c=1&etfid=CAH.US&back=ROUS
DLTR	DOLLAR TREE INC COMMON STOCK USD.01	/etf/ea/ETZCW.djhtm?c=1&etfid=DLTR.US&back=ROUS
MMS	MAXIMUS INC COMMON STOCK	/etf/ea/ETZCW.djhtm?c=1&etfid=MMS.US&back=ROUS
PRU	PRUDENTIAL FINANCIAL INC COMMON STOCK USD.01	/etf/ea/ETZCW.djhtm?c=1&etfid=PRU.US&back=ROUS
WMT	WALMART INC COMMON STOCK USD.1	/etf/ea/ETZCW.djhtm?c=1&etfid=WMT.US&back=ROUS
ORI	OLD REPUBLIC INTL CORP COMMON STOCK USD1.0	/etf/ea/ETZCW.djhtm?c=1&etfid=ORI.US&back=ROUS
GIS	GENERAL MILLS INC COMMON STOCK USD.1	/etf/ea/ETZCW.djhtm?c=1&etfid=GIS.US&back=ROUS
AXS	AXIS CAPITAL HOLDINGS LTD COMMON STOCK USD.0125	/etf/ea/ETZCW.djhtm?c=1&etfid=AXS.US&back=ROUS
	DUKE REALTY CORP REIT USD.01	
MTB	M + T BANK CORP COMMON STOCK USD.5	/etf/ea/ETZCW.djhtm?c=1&etfid=MTB.US&back=ROUS
OMC	OMNICOM GROUP COMMON STOCK USD.15	/etf/ea/ETZCW.djhtm?c=1&etfid=OMC.US&back=ROUS
K	KELLOGG CO COMMON STOCK USD.25	/etf/ea/ETZCW.djhtm?c=1&etfid=K.US&back=ROUS
CMS	CMS ENERGY CORP COMMON STOCK USD.01	/etf/ea/ETZCW.djhtm?c=1&etfid=CMS.US&back=ROUS
UFPI	UFP INDUSTRIES INC COMMON STOCK	/etf/ea/ETZCW.djhtm?c=1&etfid=UFPI.US&back=ROUS
LBTYK	LIBERTY GLOBAL PLC  C COMMON STOCK USD.01	/etf/ea/ETZCW.djhtm?c=1&etfid=LBTYK.US&back=ROUS
OTIS	OTIS WORLDWIDE CORP COMMON STOCK USD.01	/etf/ea/ETZCW.djhtm?c=1&etfid=OTIS.US&back=ROUS
KNX	KNIGHT SWIFT TRANSPORTATION COMMON STOCK USD.01	/etf/ea/ETZCW.djhtm?c=1&etfid=KNX.US&back=ROUS
CTSH	COGNIZANT TECH SOLUTIONS A COMMON STOCK USD.01	/etf/ea/ETZCW.djhtm?c=1&etfid=CTSH.US&back=ROUS
TTWO	TAKE TWO INTERACTIVE SOFTWRE COMMON STOCK USD.01	/etf/ea/ETZCW.djhtm?c=1&etfid=TTWO.US&back=ROUS
KLAC	KLA CORP COMMON STOCK USD.001	/etf/ea/ETZCW.djhtm?c=1&etfid=KLAC.US&back=ROUS
MET	METLIFE INC COMMON STOCK USD.01	/etf/ea/ETZCW.djhtm?c=1&etfid=MET.US&back=ROUS
POR	PORTLAND GENERAL ELECTRIC CO COMMON STOCK	/etf/ea/ETZCW.djhtm?c=1&etfid=POR.US&back=ROUS
RE	EVEREST RE GROUP LTD COMMON STOCK USD.01	/etf/ea/ETZCW.djhtm?c=1&etfid=RE.US&back=ROUS
ATVI	ACTIVISION BLIZZARD INC COMMON STOCK USD.000001	/etf/ea/ETZCW.djhtm?c=1&etfid=ATVI.US&back=ROUS
AEE	AMEREN CORPORATION COMMON STOCK USD.01	/etf/ea/ETZCW.djhtm?c=1&etfid=AEE.US&back=ROUS
VRTX	VERTEX PHARMACEUTICALS INC COMMON STOCK USD.01	/etf/ea/ETZCW.djhtm?c=1&etfid=VRTX.US&back=ROUS
UHAL	AMERCO COMMON STOCK USD.25	/etf/ea/ETZCW.djhtm?c=1&etfid=UHAL.US&back=ROUS
WEC	WEC ENERGY GROUP INC COMMON STOCK USD.01	/etf/ea/ETZCW.djhtm?c=1&etfid=WEC.US&back=ROUS
UTHR	UNITED THERAPEUTICS CORP COMMON STOCK USD.01	/etf/ea/ETZCW.djhtm?c=1&etfid=UTHR.US&back=ROUS
BDX	BECTON DICKINSON AND CO COMMON STOCK USD1.0	/etf/ea/ETZCW.djhtm?c=1&etfid=BDX.US&back=ROUS
CNXC	CONCENTRIX CORP COMMON STOCK	/etf/ea/ETZCW.djhtm?c=1&etfid=CNXC.US&back=ROUS
KMB	KIMBERLY CLARK CORP COMMON STOCK USD1.25	/etf/ea/ETZCW.djhtm?c=1&etfid=KMB.US&back=ROUS
IRM	IRON MOUNTAIN INC REIT USD.01	/etf/ea/ETZCW.djhtm?c=1&etfid=IRM.US&back=ROUS
JBHT	HUNT (JB) TRANSPRT SVCS INC COMMON STOCK USD.01	/etf/ea/ETZCW.djhtm?c=1&etfid=JBHT.US&back=ROUS
MCD	MCDONALD S CORP COMMON STOCK USD.01	/etf/ea/ETZCW.djhtm?c=1&etfid=MCD.US&back=ROUS
CLX	CLOROX COMPANY COMMON STOCK USD1.0	/etf/ea/ETZCW.djhtm?c=1&etfid=CLX.US&back=ROUS
EBAY	EBAY INC COMMON STOCK USD.001	/etf/ea/ETZCW.djhtm?c=1&etfid=EBAY.US&back=ROUS
CB	CHUBB LTD COMMON STOCK	/etf/ea/ETZCW.djhtm?c=1&etfid=CB.US&back=ROUS
BAX	BAXTER INTERNATIONAL INC COMMON STOCK USD1.0	/etf/ea/ETZCW.djhtm?c=1&etfid=BAX.US&back=ROUS
AEP	AMERICAN ELECTRIC POWER COMMON STOCK USD6.5	/etf/ea/ETZCW.djhtm?c=1&etfid=AEP.US&back=ROUS
JBL	JABIL INC COMMON STOCK USD.001	/etf/ea/ETZCW.djhtm?c=1&etfid=JBL.US&back=ROUS
HLI	HOULIHAN LOKEY INC COMMON STOCK USD.001	/etf/ea/ETZCW.djhtm?c=1&etfid=HLI.US&back=ROUS
WHR	WHIRLPOOL CORP COMMON STOCK USD1.0	/etf/ea/ETZCW.djhtm?c=1&etfid=WHR.US&back=ROUS
WTS	WATTS WATER TECHNOLOGIES A COMMON STOCK USD.1	/etf/ea/ETZCW.djhtm?c=1&etfid=WTS.US&back=ROUS
TRV	TRAVELERS COS INC/THE COMMON STOCK NPV	/etf/ea/ETZCW.djhtm?c=1&etfid=TRV.US&back=ROUS
HUM	HUMANA INC COMMON STOCK USD.1666666	/etf/ea/ETZCW.djhtm?c=1&etfid=HUM.US&back=ROUS
LOW	LOWE S COS INC COMMON STOCK USD.5	/etf/ea/ETZCW.djhtm?c=1&etfid=LOW.US&back=ROUS
EXC	EXELON CORP COMMON STOCK	/etf/ea/ETZCW.djhtm?c=1&etfid=EXC.US&back=ROUS
GLW	CORNING INC COMMON STOCK USD.5	/etf/ea/ETZCW.djhtm?c=1&etfid=GLW.US&back=ROUS
CMI	CUMMINS INC COMMON STOCK USD2.5	/etf/ea/ETZCW.djhtm?c=1&etfid=CMI.US&back=ROUS
CL	COLGATE PALMOLIVE CO COMMON STOCK USD1.0	/etf/ea/ETZCW.djhtm?c=1&etfid=CL.US&back=ROUS
CDNS	CADENCE DESIGN SYS INC COMMON STOCK USD.01	/etf/ea/ETZCW.djhtm?c=1&etfid=CDNS.US&back=ROUS
LXP	LXP INDUSTRIAL TRUST REIT USD.0001	/etf/ea/ETZCW.djhtm?c=1&etfid=LXP.US&back=ROUS
HE	HAWAIIAN ELECTRIC INDS COMMON STOCK	/etf/ea/ETZCW.djhtm?c=1&etfid=HE.US&back=ROUS
QCOM	QUALCOMM INC COMMON STOCK USD.0001	/etf/ea/ETZCW.djhtm?c=1&etfid=QCOM.US&back=ROUS
MMM	3M CO COMMON STOCK USD.01	/etf/ea/ETZCW.djhtm?c=1&etfid=MMM.US&back=ROUS
T	AT+T INC COMMON STOCK USD1.0	/etf/ea/ETZCW.djhtm?c=1&etfid=T.US&back=ROUS
STLD	STEEL DYNAMICS INC COMMON STOCK USD.005	/etf/ea/ETZCW.djhtm?c=1&etfid=STLD.US&back=ROUS
SJM	JM SMUCKER CO/THE COMMON STOCK	/etf/ea/ETZCW.djhtm?c=1&etfid=SJM.US&back=ROUS
UMBF	UMB FINANCIAL CORP COMMON STOCK USD1.0	/etf/ea/ETZCW.djhtm?c=1&etfid=UMBF.US&back=ROUS
RPM	RPM INTERNATIONAL INC COMMON STOCK USD.01	/etf/ea/ETZCW.djhtm?c=1&etfid=RPM.US&back=ROUS
YUM	YUM  BRANDS INC COMMON STOCK	/etf/ea/ETZCW.djhtm?c=1&etfid=YUM.US&back=ROUS
HSY	HERSHEY CO/THE COMMON STOCK USD1.0	/etf/ea/ETZCW.djhtm?c=1&etfid=HSY.US&back=ROUS
IAC	IAC INC COMMON STOCK USD.0001	/etf/ea/ETZCW.djhtm?c=1&etfid=IAC.US&back=ROUS
LSI	LIFE STORAGE INC REIT USD.01	/etf/ea/ETZCW.djhtm?c=1&etfid=LSI.US&back=ROUS
DIS	WALT DISNEY CO/THE COMMON STOCK USD.01	/etf/ea/ETZCW.djhtm?c=1&etfid=DIS.US&back=ROUS
FOXA	FOX CORP   CLASS A COMMON STOCK USD.01	/etf/ea/ETZCW.djhtm?c=1&etfid=FOXA.US&back=ROUS
ARE	ALEXANDRIA REAL ESTATE EQUIT REIT USD.01	/etf/ea/ETZCW.djhtm?c=1&etfid=ARE.US&back=ROUS
APH	AMPHENOL CORP CL A COMMON STOCK USD.001	/etf/ea/ETZCW.djhtm?c=1&etfid=APH.US&back=ROUS
NKE	NIKE INC  CL B COMMON STOCK	/etf/ea/ETZCW.djhtm?c=1&etfid=NKE.US&back=ROUS
PKG	PACKAGING CORP OF AMERICA COMMON STOCK USD.01	/etf/ea/ETZCW.djhtm?c=1&etfid=PKG.US&back=ROUS
ZION	ZIONS BANCORP NA COMMON STOCK USD.001	/etf/ea/ETZCW.djhtm?c=1&etfid=ZION.US&back=ROUS
TER	TERADYNE INC COMMON STOCK USD.125	/etf/ea/ETZCW.djhtm?c=1&etfid=TER.US&back=ROUS
WCN	WASTE CONNECTIONS INC COMMON STOCK	/etf/ea/ETZCW.djhtm?c=1&etfid=WCN.US&back=ROUS
WFC	WELLS FARGO + CO COMMON STOCK USD1.666	/etf/ea/ETZCW.djhtm?c=1&etfid=WFC.US&back=ROUS
WST	WEST PHARMACEUTICAL SERVICES COMMON STOCK USD.25	/etf/ea/ETZCW.djhtm?c=1&etfid=WST.US&back=ROUS
SO	SOUTHERN CO/THE COMMON STOCK USD5.0	/etf/ea/ETZCW.djhtm?c=1&etfid=SO.US&back=ROUS
SSB	SOUTHSTATE CORP COMMON STOCK USD2.5	/etf/ea/ETZCW.djhtm?c=1&etfid=SSB.US&back=ROUS
SCI	SERVICE CORP INTERNATIONAL COMMON STOCK USD1.0	/etf/ea/ETZCW.djhtm?c=1&etfid=SCI.US&back=ROUS
SHW	SHERWIN WILLIAMS CO/THE COMMON STOCK USD1.0	/etf/ea/ETZCW.djhtm?c=1&etfid=SHW.US&back=ROUS
NRG	NRG ENERGY INC COMMON STOCK USD.01	/etf/ea/ETZCW.djhtm?c=1&etfid=NRG.US&back=ROUS
LHX	L3HARRIS TECHNOLOGIES INC COMMON STOCK USD1.0	/etf/ea/ETZCW.djhtm?c=1&etfid=LHX.US&back=ROUS
GD	GENERAL DYNAMICS CORP COMMON STOCK USD1.0	/etf/ea/ETZCW.djhtm?c=1&etfid=GD.US&back=ROUS
CCI	CROWN CASTLE INC REIT USD.01	/etf/ea/ETZCW.djhtm?c=1&etfid=CCI.US&back=ROUS
AOS	SMITH (A.O.) CORP COMMON STOCK USD1.0	/etf/ea/ETZCW.djhtm?c=1&etfid=AOS.US&back=ROUS
AAP	ADVANCE AUTO PARTS INC COMMON STOCK USD.0001	/etf/ea/ETZCW.djhtm?c=1&etfid=AAP.US&back=ROUS
FNF	FIDELITY NATIONAL FINANCIAL COMMON STOCK USD.0001	/etf/ea/ETZCW.djhtm?c=1&etfid=FNF.US&back=ROUS
CINF	CINCINNATI FINANCIAL CORP COMMON STOCK USD2.0	/etf/ea/ETZCW.djhtm?c=1&etfid=CINF.US&back=ROUS
CPB	CAMPBELL SOUP CO COMMON STOCK USD.0375	/etf/ea/ETZCW.djhtm?c=1&etfid=CPB.US&back=ROUS
EA	ELECTRONIC ARTS INC COMMON STOCK USD.01	/etf/ea/ETZCW.djhtm?c=1&etfid=EA.US&back=ROUS
ARW	ARROW ELECTRONICS INC COMMON STOCK USD1.0	/etf/ea/ETZCW.djhtm?c=1&etfid=ARW.US&back=ROUS
MCK	MCKESSON CORP COMMON STOCK USD.01	/etf/ea/ETZCW.djhtm?c=1&etfid=MCK.US&back=ROUS
NEM	NEWMONT CORP COMMON STOCK USD1.6	/etf/ea/ETZCW.djhtm?c=1&etfid=NEM.US&back=ROUS
QLYS	QUALYS INC COMMON STOCK USD.001	/etf/ea/ETZCW.djhtm?c=1&etfid=QLYS.US&back=ROUS
XEL	XCEL ENERGY INC COMMON STOCK USD2.5	/etf/ea/ETZCW.djhtm?c=1&etfid=XEL.US&back=ROUS
WTW	WILLIS TOWERS WATSON PLC COMMON STOCK USD.000304635	/etf/ea/ETZCW.djhtm?c=1&etfid=WTW.US&back=ROUS
VRSK	VERISK ANALYTICS INC COMMON STOCK USD.001	/etf/ea/ETZCW.djhtm?c=1&etfid=VRSK.US&back=ROUS
SNPS	SYNOPSYS INC COMMON STOCK USD.01	/etf/ea/ETZCW.djhtm?c=1&etfid=SNPS.US&back=ROUS
TSN	TYSON FOODS INC CL A COMMON STOCK USD.1	/etf/ea/ETZCW.djhtm?c=1&etfid=TSN.US&back=ROUS
RJF	RAYMOND JAMES FINANCIAL INC COMMON STOCK USD.01	/etf/ea/ETZCW.djhtm?c=1&etfid=RJF.US&back=ROUS
IDA	IDACORP INC COMMON STOCK	/etf/ea/ETZCW.djhtm?c=1&etfid=IDA.US&back=ROUS
BMY	BRISTOL MYERS SQUIBB CO COMMON STOCK USD.1	/etf/ea/ETZCW.djhtm?c=1&etfid=BMY.US&back=ROUS
BG	BUNGE LTD COMMON STOCK USD.01	/etf/ea/ETZCW.djhtm?c=1&etfid=BG.US&back=ROUS
BK	BANK OF NEW YORK MELLON CORP COMMON STOCK USD.01	/etf/ea/ETZCW.djhtm?c=1&etfid=BK.US&back=ROUS
FAF	FIRST AMERICAN FINANCIAL COMMON STOCK USD.00001	/etf/ea/ETZCW.djhtm?c=1&etfid=FAF.US&back=ROUS
CMC	COMMERCIAL METALS CO COMMON STOCK USD.01	/etf/ea/ETZCW.djhtm?c=1&etfid=CMC.US&back=ROUS
D	DOMINION ENERGY INC COMMON STOCK	/etf/ea/ETZCW.djhtm?c=1&etfid=D.US&back=ROUS
DHR	DANAHER CORP COMMON STOCK USD.01	/etf/ea/ETZCW.djhtm?c=1&etfid=DHR.US&back=ROUS
CIEN	CIENA CORP COMMON STOCK USD.01	/etf/ea/ETZCW.djhtm?c=1&etfid=CIEN.US&back=ROUS
GNTX	GENTEX CORP COMMON STOCK USD.06	/etf/ea/ETZCW.djhtm?c=1&etfid=GNTX.US&back=ROUS
EIX	EDISON INTERNATIONAL COMMON STOCK	/etf/ea/ETZCW.djhtm?c=1&etfid=EIX.US&back=ROUS
	NET OTHER ASSETS	
ITW	ILLINOIS TOOL WORKS COMMON STOCK USD.01	/etf/ea/ETZCW.djhtm?c=1&etfid=ITW.US&back=ROUS
HII	HUNTINGTON INGALLS INDUSTRIE COMMON STOCK USD.01	/etf/ea/ETZCW.djhtm?c=1&etfid=HII.US&back=ROUS
TMUS	T MOBILE US INC COMMON STOCK USD.0001	/etf/ea/ETZCW.djhtm?c=1&etfid=TMUS.US&back=ROUS
RMD	RESMED INC COMMON STOCK USD.004	/etf/ea/ETZCW.djhtm?c=1&etfid=RMD.US&back=ROUS
SNA	SNAP ON INC COMMON STOCK USD1.0	/etf/ea/ETZCW.djhtm?c=1&etfid=SNA.US&back=ROUS
IT	GARTNER INC COMMON STOCK USD.0005	/etf/ea/ETZCW.djhtm?c=1&etfid=IT.US&back=ROUS
IP	INTERNATIONAL PAPER CO COMMON STOCK USD1.0	/etf/ea/ETZCW.djhtm?c=1&etfid=IP.US&back=ROUS
MAS	MASCO CORP COMMON STOCK USD1.0	/etf/ea/ETZCW.djhtm?c=1&etfid=MAS.US&back=ROUS
RL	RALPH LAUREN CORP COMMON STOCK USD.01	/etf/ea/ETZCW.djhtm?c=1&etfid=RL.US&back=ROUS
ADM	ARCHER DANIELS MIDLAND CO COMMON STOCK	/etf/ea/ETZCW.djhtm?c=1&etfid=ADM.US&back=ROUS
CHD	CHURCH + DWIGHT CO INC COMMON STOCK USD1.0	/etf/ea/ETZCW.djhtm?c=1&etfid=CHD.US&back=ROUS
CHE	CHEMED CORP COMMON STOCK USD1.0	/etf/ea/ETZCW.djhtm?c=1&etfid=CHE.US&back=ROUS
FE	FIRSTENERGY CORP COMMON STOCK USD.1	/etf/ea/ETZCW.djhtm?c=1&etfid=FE.US&back=ROUS
CUBE	CUBESMART REIT USD.01	/etf/ea/ETZCW.djhtm?c=1&etfid=CUBE.US&back=ROUS
DUK	DUKE ENERGY CORP COMMON STOCK USD.001	/etf/ea/ETZCW.djhtm?c=1&etfid=DUK.US&back=ROUS
FN	FABRINET COMMON STOCK USD.01	/etf/ea/ETZCW.djhtm?c=1&etfid=FN.US&back=ROUS
EPAM	EPAM SYSTEMS INC COMMON STOCK USD.001	/etf/ea/ETZCW.djhtm?c=1&etfid=EPAM.US&back=ROUS
EQIX	EQUINIX INC REIT USD.001	/etf/ea/ETZCW.djhtm?c=1&etfid=EQIX.US&back=ROUS
ATO	ATMOS ENERGY CORP COMMON STOCK	/etf/ea/ETZCW.djhtm?c=1&etfid=ATO.US&back=ROUS
AMCR	AMCOR PLC COMMON STOCK USD.01	/etf/ea/ETZCW.djhtm?c=1&etfid=AMCR.US&back=ROUS
PCAR	PACCAR INC COMMON STOCK USD1.0	/etf/ea/ETZCW.djhtm?c=1&etfid=PCAR.US&back=ROUS
NYCB	NEW YORK COMMUNITY BANCORP COMMON STOCK USD.01	/etf/ea/ETZCW.djhtm?c=1&etfid=NYCB.US&back=ROUS
OGE	OGE ENERGY CORP COMMON STOCK USD.01	/etf/ea/ETZCW.djhtm?c=1&etfid=OGE.US&back=ROUS
MKL	MARKEL CORP COMMON STOCK	/etf/ea/ETZCW.djhtm?c=1&etfid=MKL.US&back=ROUS
J	JACOBS SOLUTIONS INC COMMON STOCK	/etf/ea/ETZCW.djhtm?c=1&etfid=J.US&back=ROUS
ODFL	OLD DOMINION FREIGHT LINE COMMON STOCK USD.1	/etf/ea/ETZCW.djhtm?c=1&etfid=ODFL.US&back=ROUS
AMT	AMERICAN TOWER CORP REIT USD.01	/etf/ea/ETZCW.djhtm?c=1&etfid=AMT.US&back=ROUS
AVY	AVERY DENNISON CORP COMMON STOCK USD1.0	/etf/ea/ETZCW.djhtm?c=1&etfid=AVY.US&back=ROUS
VOYA	VOYA FINANCIAL INC COMMON STOCK USD.01	/etf/ea/ETZCW.djhtm?c=1&etfid=VOYA.US&back=ROUS
ZTS	ZOETIS INC COMMON STOCK USD.01	/etf/ea/ETZCW.djhtm?c=1&etfid=ZTS.US&back=ROUS
WBA	WALGREENS BOOTS ALLIANCE INC COMMON STOCK USD.01	/etf/ea/ETZCW.djhtm?c=1&etfid=WBA.US&back=ROUS
SIGI	SELECTIVE INSURANCE GROUP COMMON STOCK USD2.0	/etf/ea/ETZCW.djhtm?c=1&etfid=SIGI.US&back=ROUS
TEL	TE CONNECTIVITY LTD COMMON STOCK CHF.57	/etf/ea/ETZCW.djhtm?c=1&etfid=TEL.US&back=ROUS
AMD	ADVANCED MICRO DEVICES COMMON STOCK USD.01	/etf/ea/ETZCW.djhtm?c=1&etfid=AMD.US&back=ROUS
ANET	ARISTA NETWORKS INC COMMON STOCK USD.0001	/etf/ea/ETZCW.djhtm?c=1&etfid=ANET.US&back=ROUS
DBX	DROPBOX INC CLASS A COMMON STOCK USD.00001	/etf/ea/ETZCW.djhtm?c=1&etfid=DBX.US&back=ROUS
DHI	DR HORTON INC COMMON STOCK USD.01	/etf/ea/ETZCW.djhtm?c=1&etfid=DHI.US&back=ROUS
PNC	PNC FINANCIAL SERVICES GROUP COMMON STOCK USD5.0	/etf/ea/ETZCW.djhtm?c=1&etfid=PNC.US&back=ROUS
RHI	ROBERT HALF INTL INC COMMON STOCK USD.001	/etf/ea/ETZCW.djhtm?c=1&etfid=RHI.US&back=ROUS
MPWR	MONOLITHIC POWER SYSTEMS INC COMMON STOCK USD.001	/etf/ea/ETZCW.djhtm?c=1&etfid=MPWR.US&back=ROUS
MAN	MANPOWERGROUP INC COMMON STOCK USD.01	/etf/ea/ETZCW.djhtm?c=1&etfid=MAN.US&back=ROUS
LNT	ALLIANT ENERGY CORP COMMON STOCK USD.01	/etf/ea/ETZCW.djhtm?c=1&etfid=LNT.US&back=ROUS
EQR	EQUITY RESIDENTIAL REIT USD.01	/etf/ea/ETZCW.djhtm?c=1&etfid=EQR.US&back=ROUS
ES	EVERSOURCE ENERGY COMMON STOCK USD5.0	/etf/ea/ETZCW.djhtm?c=1&etfid=ES.US&back=ROUS
WAT	WATERS CORP COMMON STOCK USD.01	/etf/ea/ETZCW.djhtm?c=1&etfid=WAT.US&back=ROUS
UGI	UGI CORP COMMON STOCK	/etf/ea/ETZCW.djhtm?c=1&etfid=UGI.US&back=ROUS
TYL	TYLER TECHNOLOGIES INC COMMON STOCK USD.01	/etf/ea/ETZCW.djhtm?c=1&etfid=TYL.US&back=ROUS
UBSI	UNITED BANKSHARES INC COMMON STOCK USD2.5	/etf/ea/ETZCW.djhtm?c=1&etfid=UBSI.US&back=ROUS
VMW	VMWARE INC CLASS A  W/I COMMON STOCK USD.01	/etf/ea/ETZCW.djhtm?c=1&etfid=VMW.US&back=ROUS
THG	HANOVER INSURANCE GROUP INC/ COMMON STOCK USD.01	/etf/ea/ETZCW.djhtm?c=1&etfid=THG.US&back=ROUS
ZBRA	ZEBRA TECHNOLOGIES CORP CL A COMMON STOCK USD.01	/etf/ea/ETZCW.djhtm?c=1&etfid=ZBRA.US&back=ROUS
EVRG	EVERGY INC COMMON STOCK	/etf/ea/ETZCW.djhtm?c=1&etfid=EVRG.US&back=ROUS
FTNT	FORTINET INC COMMON STOCK USD.001	/etf/ea/ETZCW.djhtm?c=1&etfid=FTNT.US&back=ROUS
CI	CIGNA CORP COMMON STOCK USD.01	/etf/ea/ETZCW.djhtm?c=1&etfid=CI.US&back=ROUS
MMC	MARSH + MCLENNAN COS COMMON STOCK USD1.0	/etf/ea/ETZCW.djhtm?c=1&etfid=MMC.US&back=ROUS
MAA	MID AMERICA APARTMENT COMM REIT USD.01	/etf/ea/ETZCW.djhtm?c=1&etfid=MAA.US&back=ROUS
LRCX	LAM RESEARCH CORP COMMON STOCK USD.001	/etf/ea/ETZCW.djhtm?c=1&etfid=LRCX.US&back=ROUS
GRMN	GARMIN LTD COMMON STOCK CHF.1	/etf/ea/ETZCW.djhtm?c=1&etfid=GRMN.US&back=ROUS
HUN	HUNTSMAN CORP COMMON STOCK USD.01	/etf/ea/ETZCW.djhtm?c=1&etfid=HUN.US&back=ROUS
HSIC	HENRY SCHEIN INC COMMON STOCK USD.01	/etf/ea/ETZCW.djhtm?c=1&etfid=HSIC.US&back=ROUS
MTD	METTLER TOLEDO INTERNATIONAL COMMON STOCK USD.01	/etf/ea/ETZCW.djhtm?c=1&etfid=MTD.US&back=ROUS
NI	NISOURCE INC COMMON STOCK USD.01	/etf/ea/ETZCW.djhtm?c=1&etfid=NI.US&back=ROUS
NWSA	NEWS CORP   CLASS A COMMON STOCK USD.01	/etf/ea/ETZCW.djhtm?c=1&etfid=NWSA.US&back=ROUS
PM	PHILIP MORRIS INTERNATIONAL COMMON STOCK	/etf/ea/ETZCW.djhtm?c=1&etfid=PM.US&back=ROUS
FDX	FEDEX CORP COMMON STOCK USD.1	/etf/ea/ETZCW.djhtm?c=1&etfid=FDX.US&back=ROUS
EXLS	EXLSERVICE HOLDINGS INC COMMON STOCK USD.001	/etf/ea/ETZCW.djhtm?c=1&etfid=EXLS.US&back=ROUS
APD	AIR PRODUCTS + CHEMICALS INC COMMON STOCK USD1.0	/etf/ea/ETZCW.djhtm?c=1&etfid=APD.US&back=ROUS
AMAT	APPLIED MATERIALS INC COMMON STOCK USD.01	/etf/ea/ETZCW.djhtm?c=1&etfid=AMAT.US&back=ROUS
SBAC	SBA COMMUNICATIONS CORP REIT USD.01	/etf/ea/ETZCW.djhtm?c=1&etfid=SBAC.US&back=ROUS
ROL	ROLLINS INC COMMON STOCK USD1.0	/etf/ea/ETZCW.djhtm?c=1&etfid=ROL.US&back=ROUS
SSD	SIMPSON MANUFACTURING CO INC COMMON STOCK USD.01	/etf/ea/ETZCW.djhtm?c=1&etfid=SSD.US&back=ROUS
TJX	TJX COMPANIES INC COMMON STOCK USD1.0	/etf/ea/ETZCW.djhtm?c=1&etfid=TJX.US&back=ROUS
SWX	SOUTHWEST GAS HOLDINGS INC COMMON STOCK USD1.0	/etf/ea/ETZCW.djhtm?c=1&etfid=SWX.US&back=ROUS
CBOE	CBOE GLOBAL MARKETS INC COMMON STOCK	/etf/ea/ETZCW.djhtm?c=1&etfid=CBOE.US&back=ROUS
CARR	CARRIER GLOBAL CORP COMMON STOCK USD.01	/etf/ea/ETZCW.djhtm?c=1&etfid=CARR.US&back=ROUS
PFG	PRINCIPAL FINANCIAL GROUP COMMON STOCK USD.01	/etf/ea/ETZCW.djhtm?c=1&etfid=PFG.US&back=ROUS
PZZA	PAPA JOHN S INTL INC COMMON STOCK USD.01	/etf/ea/ETZCW.djhtm?c=1&etfid=PZZA.US&back=ROUS
NOW	SERVICENOW INC COMMON STOCK USD.001	/etf/ea/ETZCW.djhtm?c=1&etfid=NOW.US&back=ROUS
MU	MICRON TECHNOLOGY INC COMMON STOCK USD.1	/etf/ea/ETZCW.djhtm?c=1&etfid=MU.US&back=ROUS
HOLX	HOLOGIC INC COMMON STOCK USD.01	/etf/ea/ETZCW.djhtm?c=1&etfid=HOLX.US&back=ROUS
LH	LABORATORY CRP OF AMER HLDGS COMMON STOCK USD.1	/etf/ea/ETZCW.djhtm?c=1&etfid=LH.US&back=ROUS
JEF	JEFFERIES FINANCIAL GROUP IN COMMON STOCK USD1.0	/etf/ea/ETZCW.djhtm?c=1&etfid=JEF.US&back=ROUS
NFLX	NETFLIX INC COMMON STOCK USD.001	/etf/ea/ETZCW.djhtm?c=1&etfid=NFLX.US&back=ROUS
NYT	NEW YORK TIMES CO A COMMON STOCK USD.1	/etf/ea/ETZCW.djhtm?c=1&etfid=NYT.US&back=ROUS
CAG	CONAGRA BRANDS INC COMMON STOCK USD5.0	/etf/ea/ETZCW.djhtm?c=1&etfid=CAG.US&back=ROUS
AVB	AVALONBAY COMMUNITIES INC REIT USD.01	/etf/ea/ETZCW.djhtm?c=1&etfid=AVB.US&back=ROUS
AZPN	ASPEN TECHNOLOGY INC COMMON STOCK	/etf/ea/ETZCW.djhtm?c=1&etfid=AZPN.US&back=ROUS
BEN	FRANKLIN RESOURCES INC COMMON STOCK USD.1	/etf/ea/ETZCW.djhtm?c=1&etfid=BEN.US&back=ROUS
AIG	AMERICAN INTERNATIONAL GROUP COMMON STOCK USD2.5	/etf/ea/ETZCW.djhtm?c=1&etfid=AIG.US&back=ROUS
AJG	ARTHUR J GALLAGHER + CO COMMON STOCK USD1.0	/etf/ea/ETZCW.djhtm?c=1&etfid=AJG.US&back=ROUS
ATR	APTARGROUP INC COMMON STOCK USD.01	/etf/ea/ETZCW.djhtm?c=1&etfid=ATR.US&back=ROUS
ETR	ENTERGY CORP COMMON STOCK USD.01	/etf/ea/ETZCW.djhtm?c=1&etfid=ETR.US&back=ROUS
FFIV	F5 INC COMMON STOCK	/etf/ea/ETZCW.djhtm?c=1&etfid=FFIV.US&back=ROUS
COO	COOPER COS INC/THE COMMON STOCK USD.1	/etf/ea/ETZCW.djhtm?c=1&etfid=COO.US&back=ROUS
DKS	DICK S SPORTING GOODS INC COMMON STOCK USD.01	/etf/ea/ETZCW.djhtm?c=1&etfid=DKS.US&back=ROUS
PKI	PERKINELMER INC COMMON STOCK USD1.0	/etf/ea/ETZCW.djhtm?c=1&etfid=PKI.US&back=ROUS
IBKR	INTERACTIVE BROKERS GRO CL A COMMON STOCK USD.01	/etf/ea/ETZCW.djhtm?c=1&etfid=IBKR.US&back=ROUS
ICE	INTERCONTINENTAL EXCHANGE IN COMMON STOCK USD.01	/etf/ea/ETZCW.djhtm?c=1&etfid=ICE.US&back=ROUS
LII	LENNOX INTERNATIONAL INC COMMON STOCK USD.01	/etf/ea/ETZCW.djhtm?c=1&etfid=LII.US&back=ROUS
LPX	LOUISIANA PACIFIC CORP COMMON STOCK USD1.0	/etf/ea/ETZCW.djhtm?c=1&etfid=LPX.US&back=ROUS
JCI	JOHNSON CONTROLS INTERNATION COMMON STOCK USD.01	/etf/ea/ETZCW.djhtm?c=1&etfid=JCI.US&back=ROUS
PLD	PROLOGIS INC REIT USD.01	/etf/ea/ETZCW.djhtm?c=1&etfid=PLD.US&back=ROUS
FL	FOOT LOCKER INC COMMON STOCK USD.01	/etf/ea/ETZCW.djhtm?c=1&etfid=FL.US&back=ROUS
ACGL	ARCH CAPITAL GROUP LTD COMMON STOCK USD.01	/etf/ea/ETZCW.djhtm?c=1&etfid=ACGL.US&back=ROUS
CASY	CASEY S GENERAL STORES INC COMMON STOCK NPV	/etf/ea/ETZCW.djhtm?c=1&etfid=CASY.US&back=ROUS
SBUX	STARBUCKS CORP COMMON STOCK USD.001	/etf/ea/ETZCW.djhtm?c=1&etfid=SBUX.US&back=ROUS
STAG	STAG INDUSTRIAL INC REIT USD.01	/etf/ea/ETZCW.djhtm?c=1&etfid=STAG.US&back=ROUS
	BALL CORP COMMON STOCK	
CHTR	CHARTER COMMUNICATIONS INC A COMMON STOCK USD.001	/etf/ea/ETZCW.djhtm?c=1&etfid=CHTR.US&back=ROUS
AWK	AMERICAN WATER WORKS CO INC COMMON STOCK USD.01	/etf/ea/ETZCW.djhtm?c=1&etfid=AWK.US&back=ROUS
ENTG	ENTEGRIS INC COMMON STOCK USD.01	/etf/ea/ETZCW.djhtm?c=1&etfid=ENTG.US&back=ROUS
NSA	NATIONAL STORAGE AFFILIATES REIT USD.01	/etf/ea/ETZCW.djhtm?c=1&etfid=NSA.US&back=ROUS
MO	ALTRIA GROUP INC COMMON STOCK USD.333	/etf/ea/ETZCW.djhtm?c=1&etfid=MO.US&back=ROUS
MOH	MOLINA HEALTHCARE INC COMMON STOCK USD.001	/etf/ea/ETZCW.djhtm?c=1&etfid=MOH.US&back=ROUS
IPG	INTERPUBLIC GROUP OF COS INC COMMON STOCK USD.1	/etf/ea/ETZCW.djhtm?c=1&etfid=IPG.US&back=ROUS
LUMN	LUMEN TECHNOLOGIES INC COMMON STOCK USD1.0	/etf/ea/ETZCW.djhtm?c=1&etfid=LUMN.US&back=ROUS
KRC	KILROY REALTY CORP REIT USD.01	/etf/ea/ETZCW.djhtm?c=1&etfid=KRC.US&back=ROUS
L	LOEWS CORP COMMON STOCK USD.01	/etf/ea/ETZCW.djhtm?c=1&etfid=L.US&back=ROUS
GGG	GRACO INC COMMON STOCK USD1.0	/etf/ea/ETZCW.djhtm?c=1&etfid=GGG.US&back=ROUS
HRL	HORMEL FOODS CORP COMMON STOCK USD.01465	/etf/ea/ETZCW.djhtm?c=1&etfid=HRL.US&back=ROUS
REXR	REXFORD INDUSTRIAL REALTY IN REIT USD.01	/etf/ea/ETZCW.djhtm?c=1&etfid=REXR.US&back=ROUS
CPT	CAMDEN PROPERTY TRUST REIT USD.01	/etf/ea/ETZCW.djhtm?c=1&etfid=CPT.US&back=ROUS
TTC	TORO CO COMMON STOCK USD1.0	/etf/ea/ETZCW.djhtm?c=1&etfid=TTC.US&back=ROUS
UMPQ	UMPQUA HOLDINGS CORP COMMON STOCK	/etf/ea/ETZCW.djhtm?c=1&etfid=UMPQ.US&back=ROUS
WBD	WARNER BROS DISCOVERY INC COMMON STOCK	/etf/ea/ETZCW.djhtm?c=1&etfid=WBD.US&back=ROUS
WSM	WILLIAMS SONOMA INC COMMON STOCK USD.01	/etf/ea/ETZCW.djhtm?c=1&etfid=WSM.US&back=ROUS
USB	US BANCORP COMMON STOCK USD.01	/etf/ea/ETZCW.djhtm?c=1&etfid=USB.US&back=ROUS
TRNO	TERRENO REALTY CORP REIT USD.01	/etf/ea/ETZCW.djhtm?c=1&etfid=TRNO.US&back=ROUS
SIRI	SIRIUS XM HOLDINGS INC COMMON STOCK USD.001	/etf/ea/ETZCW.djhtm?c=1&etfid=SIRI.US&back=ROUS
DIOD	DIODES INC COMMON STOCK USD.667	/etf/ea/ETZCW.djhtm?c=1&etfid=DIOD.US&back=ROUS
EFX	EQUIFAX INC COMMON STOCK USD1.25	/etf/ea/ETZCW.djhtm?c=1&etfid=EFX.US&back=ROUS
BKI	BLACK KNIGHT INC COMMON STOCK	/etf/ea/ETZCW.djhtm?c=1&etfid=BKI.US&back=ROUS
BCPC	BALCHEM CORP COMMON STOCK USD.0667	/etf/ea/ETZCW.djhtm?c=1&etfid=BCPC.US&back=ROUS
AIZ	ASSURANT INC COMMON STOCK USD.01	/etf/ea/ETZCW.djhtm?c=1&etfid=AIZ.US&back=ROUS
AFL	AFLAC INC COMMON STOCK USD.1	/etf/ea/ETZCW.djhtm?c=1&etfid=AFL.US&back=ROUS
ANSS	ANSYS INC COMMON STOCK USD.01	/etf/ea/ETZCW.djhtm?c=1&etfid=ANSS.US&back=ROUS
POWI	POWER INTEGRATIONS INC COMMON STOCK USD.001	/etf/ea/ETZCW.djhtm?c=1&etfid=POWI.US&back=ROUS
PPL	PPL CORP COMMON STOCK USD.01	/etf/ea/ETZCW.djhtm?c=1&etfid=PPL.US&back=ROUS
NDAQ	NASDAQ INC COMMON STOCK USD.01	/etf/ea/ETZCW.djhtm?c=1&etfid=NDAQ.US&back=ROUS
NVR	NVR INC COMMON STOCK USD.01	/etf/ea/ETZCW.djhtm?c=1&etfid=NVR.US&back=ROUS
MASI	MASIMO CORP COMMON STOCK USD.001	/etf/ea/ETZCW.djhtm?c=1&etfid=MASI.US&back=ROUS
PANW	PALO ALTO NETWORKS INC COMMON STOCK USD.0001	/etf/ea/ETZCW.djhtm?c=1&etfid=PANW.US&back=ROUS
AMH	AMERICAN HOMES 4 RENT  A REIT USD.01	/etf/ea/ETZCW.djhtm?c=1&etfid=AMH.US&back=ROUS
C	CITIGROUP INC COMMON STOCK USD.01	/etf/ea/ETZCW.djhtm?c=1&etfid=C.US&back=ROUS
	S+P500 EMINI FUT  SEP22 XCME 20220916	
EMBC	EMBECTA CORP COMMON STOCK USD.01	/etf/ea/ETZCW.djhtm?c=1&etfid=EMBC.US&back=ROUS
F	FORD MOTOR CO COMMON STOCK USD.01	/etf/ea/ETZCW.djhtm?c=1&etfid=F.US&back=ROUS
