SPLG
AAPL	Apple Inc.	/etf/ea/ETZCW.djhtm?c=1&etfid=AAPL.US&back=SPLG
MSFT	Microsoft Corporation	/etf/ea/ETZCW.djhtm?c=1&etfid=MSFT.US&back=SPLG
AMZN	Amazon.com Inc.	/etf/ea/ETZCW.djhtm?c=1&etfid=AMZN.US&back=SPLG
TSLA	Tesla Inc	/etf/ea/ETZCW.djhtm?c=1&etfid=TSLA.US&back=SPLG
GOOGL	Alphabet Inc. Class A	/etf/ea/ETZCW.djhtm?c=1&etfid=GOOGL.US&back=SPLG
GOOG	Alphabet Inc. Class C	/etf/ea/ETZCW.djhtm?c=1&etfid=GOOG.US&back=SPLG
BRK.B	Berkshire Hathaway Inc. Class B	/etf/ea/ETZCW.djhtm?c=1&etfid=BRK.B.US&back=SPLG
UNH	UnitedHealth Group Incorporated	/etf/ea/ETZCW.djhtm?c=1&etfid=UNH.US&back=SPLG
JNJ	Johnson & Johnson	/etf/ea/ETZCW.djhtm?c=1&etfid=JNJ.US&back=SPLG
XOM	Exxon Mobil Corporation	/etf/ea/ETZCW.djhtm?c=1&etfid=XOM.US&back=SPLG
NVDA	NVIDIA Corporation	/etf/ea/ETZCW.djhtm?c=1&etfid=NVDA.US&back=SPLG
META	Meta Platforms Inc. Class A	/etf/ea/ETZCW.djhtm?c=1&etfid=META.US&back=SPLG
JPM	JPMorgan Chase & Co.	/etf/ea/ETZCW.djhtm?c=1&etfid=JPM.US&back=SPLG
PG	Procter & Gamble Company	/etf/ea/ETZCW.djhtm?c=1&etfid=PG.US&back=SPLG
V	Visa Inc. Class A	/etf/ea/ETZCW.djhtm?c=1&etfid=V.US&back=SPLG
CVX	Chevron Corporation	/etf/ea/ETZCW.djhtm?c=1&etfid=CVX.US&back=SPLG
HD	Home Depot Inc.	/etf/ea/ETZCW.djhtm?c=1&etfid=HD.US&back=SPLG
MA	Mastercard Incorporated Class A	/etf/ea/ETZCW.djhtm?c=1&etfid=MA.US&back=SPLG
PFE	Pfizer Inc.	/etf/ea/ETZCW.djhtm?c=1&etfid=PFE.US&back=SPLG
KO	Coca-Cola Company	/etf/ea/ETZCW.djhtm?c=1&etfid=KO.US&back=SPLG
BAC	Bank of America Corp	/etf/ea/ETZCW.djhtm?c=1&etfid=BAC.US&back=SPLG
LLY	Eli Lilly and Company	/etf/ea/ETZCW.djhtm?c=1&etfid=LLY.US&back=SPLG
PEP	PepsiCo Inc.	/etf/ea/ETZCW.djhtm?c=1&etfid=PEP.US&back=SPLG
ABBV	AbbVie Inc.	/etf/ea/ETZCW.djhtm?c=1&etfid=ABBV.US&back=SPLG
COST	Costco Wholesale Corporation	/etf/ea/ETZCW.djhtm?c=1&etfid=COST.US&back=SPLG
MRK	Merck & Co. Inc.	/etf/ea/ETZCW.djhtm?c=1&etfid=MRK.US&back=SPLG
TMO	Thermo Fisher Scientific Inc.	/etf/ea/ETZCW.djhtm?c=1&etfid=TMO.US&back=SPLG
DIS	Walt Disney Company	/etf/ea/ETZCW.djhtm?c=1&etfid=DIS.US&back=SPLG
AVGO	Broadcom Inc.	/etf/ea/ETZCW.djhtm?c=1&etfid=AVGO.US&back=SPLG
MCD	McDonald's Corporation	/etf/ea/ETZCW.djhtm?c=1&etfid=MCD.US&back=SPLG
WMT	Walmart Inc.	/etf/ea/ETZCW.djhtm?c=1&etfid=WMT.US&back=SPLG
CSCO	Cisco Systems Inc.	/etf/ea/ETZCW.djhtm?c=1&etfid=CSCO.US&back=SPLG
ACN	Accenture Plc Class A	/etf/ea/ETZCW.djhtm?c=1&etfid=ACN.US&back=SPLG
ABT	Abbott Laboratories	/etf/ea/ETZCW.djhtm?c=1&etfid=ABT.US&back=SPLG
ADBE	Adobe Incorporated	/etf/ea/ETZCW.djhtm?c=1&etfid=ADBE.US&back=SPLG
VZ	Verizon Communications Inc.	/etf/ea/ETZCW.djhtm?c=1&etfid=VZ.US&back=SPLG
DHR	Danaher Corporation	/etf/ea/ETZCW.djhtm?c=1&etfid=DHR.US&back=SPLG
NEE	NextEra Energy Inc.	/etf/ea/ETZCW.djhtm?c=1&etfid=NEE.US&back=SPLG
WFC	Wells Fargo & Company	/etf/ea/ETZCW.djhtm?c=1&etfid=WFC.US&back=SPLG
CMCSA	Comcast Corporation Class A	/etf/ea/ETZCW.djhtm?c=1&etfid=CMCSA.US&back=SPLG
CRM	Salesforce Inc.	/etf/ea/ETZCW.djhtm?c=1&etfid=CRM.US&back=SPLG
TXN	Texas Instruments Incorporated	/etf/ea/ETZCW.djhtm?c=1&etfid=TXN.US&back=SPLG
QCOM	Qualcomm Incorporated	/etf/ea/ETZCW.djhtm?c=1&etfid=QCOM.US&back=SPLG
PM	Philip Morris International Inc.	/etf/ea/ETZCW.djhtm?c=1&etfid=PM.US&back=SPLG
BMY	Bristol-Myers Squibb Company	/etf/ea/ETZCW.djhtm?c=1&etfid=BMY.US&back=SPLG
UPS	United Parcel Service Inc. Class B	/etf/ea/ETZCW.djhtm?c=1&etfid=UPS.US&back=SPLG
LIN	Linde plc	/etf/ea/ETZCW.djhtm?c=1&etfid=LIN.US&back=SPLG
COP	ConocoPhillips	/etf/ea/ETZCW.djhtm?c=1&etfid=COP.US&back=SPLG
UNP	Union Pacific Corporation	/etf/ea/ETZCW.djhtm?c=1&etfid=UNP.US&back=SPLG
AMD	Advanced Micro Devices Inc.	/etf/ea/ETZCW.djhtm?c=1&etfid=AMD.US&back=SPLG
NKE	NIKE Inc. Class B	/etf/ea/ETZCW.djhtm?c=1&etfid=NKE.US&back=SPLG
RTX	Raytheon Technologies Corporation	/etf/ea/ETZCW.djhtm?c=1&etfid=RTX.US&back=SPLG
INTC	Intel Corporation	/etf/ea/ETZCW.djhtm?c=1&etfid=INTC.US&back=SPLG
HON	Honeywell International Inc.	/etf/ea/ETZCW.djhtm?c=1&etfid=HON.US&back=SPLG
CVS	CVS Health Corporation	/etf/ea/ETZCW.djhtm?c=1&etfid=CVS.US&back=SPLG
LOW	Lowe's Companies Inc.	/etf/ea/ETZCW.djhtm?c=1&etfid=LOW.US&back=SPLG
AMGN	Amgen Inc.	/etf/ea/ETZCW.djhtm?c=1&etfid=AMGN.US&back=SPLG
T	AT&T Inc.	/etf/ea/ETZCW.djhtm?c=1&etfid=T.US&back=SPLG
SPGI	S&P Global Inc.	/etf/ea/ETZCW.djhtm?c=1&etfid=SPGI.US&back=SPLG
INTU	Intuit Inc.	/etf/ea/ETZCW.djhtm?c=1&etfid=INTU.US&back=SPLG
MS	Morgan Stanley	/etf/ea/ETZCW.djhtm?c=1&etfid=MS.US&back=SPLG
MDT	Medtronic Plc	/etf/ea/ETZCW.djhtm?c=1&etfid=MDT.US&back=SPLG
AMT	American Tower Corporation	/etf/ea/ETZCW.djhtm?c=1&etfid=AMT.US&back=SPLG
ELV	Elevance Health Inc.	/etf/ea/ETZCW.djhtm?c=1&etfid=ELV.US&back=SPLG
ORCL	Oracle Corporation	/etf/ea/ETZCW.djhtm?c=1&etfid=ORCL.US&back=SPLG
IBM	International Business Machines Corporation	/etf/ea/ETZCW.djhtm?c=1&etfid=IBM.US&back=SPLG
GS	Goldman Sachs Group Inc.	/etf/ea/ETZCW.djhtm?c=1&etfid=GS.US&back=SPLG
PYPL	PayPal Holdings Inc.	/etf/ea/ETZCW.djhtm?c=1&etfid=PYPL.US&back=SPLG
SCHW	Charles Schwab Corp	/etf/ea/ETZCW.djhtm?c=1&etfid=SCHW.US&back=SPLG
ADP	Automatic Data Processing Inc.	/etf/ea/ETZCW.djhtm?c=1&etfid=ADP.US&back=SPLG
DE	Deere & Company	/etf/ea/ETZCW.djhtm?c=1&etfid=DE.US&back=SPLG
LMT	Lockheed Martin Corporation	/etf/ea/ETZCW.djhtm?c=1&etfid=LMT.US&back=SPLG
NFLX	Netflix Inc.	/etf/ea/ETZCW.djhtm?c=1&etfid=NFLX.US&back=SPLG
CAT	Caterpillar Inc.	/etf/ea/ETZCW.djhtm?c=1&etfid=CAT.US&back=SPLG
SBUX	Starbucks Corporation	/etf/ea/ETZCW.djhtm?c=1&etfid=SBUX.US&back=SPLG
BLK	BlackRock Inc.	/etf/ea/ETZCW.djhtm?c=1&etfid=BLK.US&back=SPLG
C	Citigroup Inc.	/etf/ea/ETZCW.djhtm?c=1&etfid=C.US&back=SPLG
AXP	American Express Company	/etf/ea/ETZCW.djhtm?c=1&etfid=AXP.US&back=SPLG
PLD	Prologis Inc.	/etf/ea/ETZCW.djhtm?c=1&etfid=PLD.US&back=SPLG
CI	Cigna Corporation	/etf/ea/ETZCW.djhtm?c=1&etfid=CI.US&back=SPLG
BA	Boeing Company	/etf/ea/ETZCW.djhtm?c=1&etfid=BA.US&back=SPLG
NOW	ServiceNow Inc.	/etf/ea/ETZCW.djhtm?c=1&etfid=NOW.US&back=SPLG
MDLZ	Mondelez International Inc. Class A	/etf/ea/ETZCW.djhtm?c=1&etfid=MDLZ.US&back=SPLG
TMUS	T-Mobile US Inc.	/etf/ea/ETZCW.djhtm?c=1&etfid=TMUS.US&back=SPLG
AMAT	Applied Materials Inc.	/etf/ea/ETZCW.djhtm?c=1&etfid=AMAT.US&back=SPLG
DUK	Duke Energy Corporation	/etf/ea/ETZCW.djhtm?c=1&etfid=DUK.US&back=SPLG
MO	Altria Group Inc	/etf/ea/ETZCW.djhtm?c=1&etfid=MO.US&back=SPLG
SO	Southern Company	/etf/ea/ETZCW.djhtm?c=1&etfid=SO.US&back=SPLG
MMC	Marsh & McLennan Companies Inc.	/etf/ea/ETZCW.djhtm?c=1&etfid=MMC.US&back=SPLG
GE	General Electric Company	/etf/ea/ETZCW.djhtm?c=1&etfid=GE.US&back=SPLG
CB	Chubb Limited	/etf/ea/ETZCW.djhtm?c=1&etfid=CB.US&back=SPLG
ADI	Analog Devices Inc.	/etf/ea/ETZCW.djhtm?c=1&etfid=ADI.US&back=SPLG
GILD	Gilead Sciences Inc.	/etf/ea/ETZCW.djhtm?c=1&etfid=GILD.US&back=SPLG
	STATE STREET INSTITUTIONAL LIQ STATE STR	
BKNG	Booking Holdings Inc.	/etf/ea/ETZCW.djhtm?c=1&etfid=BKNG.US&back=SPLG
TGT	Target Corporation	/etf/ea/ETZCW.djhtm?c=1&etfid=TGT.US&back=SPLG
CCI	Crown Castle Inc.	/etf/ea/ETZCW.djhtm?c=1&etfid=CCI.US&back=SPLG
ZTS	Zoetis Inc. Class A	/etf/ea/ETZCW.djhtm?c=1&etfid=ZTS.US&back=SPLG
ISRG	Intuitive Surgical Inc.	/etf/ea/ETZCW.djhtm?c=1&etfid=ISRG.US&back=SPLG
TJX	TJX Companies Inc	/etf/ea/ETZCW.djhtm?c=1&etfid=TJX.US&back=SPLG
BDX	Becton Dickinson and Company	/etf/ea/ETZCW.djhtm?c=1&etfid=BDX.US&back=SPLG
VRTX	Vertex Pharmaceuticals Incorporated	/etf/ea/ETZCW.djhtm?c=1&etfid=VRTX.US&back=SPLG
PGR	Progressive Corporation	/etf/ea/ETZCW.djhtm?c=1&etfid=PGR.US&back=SPLG
MMM	3M Company	/etf/ea/ETZCW.djhtm?c=1&etfid=MMM.US&back=SPLG
EOG	EOG Resources Inc.	/etf/ea/ETZCW.djhtm?c=1&etfid=EOG.US&back=SPLG
CME	CME Group Inc. Class A	/etf/ea/ETZCW.djhtm?c=1&etfid=CME.US&back=SPLG
NOC	Northrop Grumman Corp.	/etf/ea/ETZCW.djhtm?c=1&etfid=NOC.US&back=SPLG
SYK	Stryker Corporation	/etf/ea/ETZCW.djhtm?c=1&etfid=SYK.US&back=SPLG
CSX	CSX Corporation	/etf/ea/ETZCW.djhtm?c=1&etfid=CSX.US&back=SPLG
D	Dominion Energy Inc	/etf/ea/ETZCW.djhtm?c=1&etfid=D.US&back=SPLG
CL	Colgate-Palmolive Company	/etf/ea/ETZCW.djhtm?c=1&etfid=CL.US&back=SPLG
PNC	PNC Financial Services Group Inc.	/etf/ea/ETZCW.djhtm?c=1&etfid=PNC.US&back=SPLG
WM	Waste Management Inc.	/etf/ea/ETZCW.djhtm?c=1&etfid=WM.US&back=SPLG
MU	Micron Technology Inc.	/etf/ea/ETZCW.djhtm?c=1&etfid=MU.US&back=SPLG
REGN	Regeneron Pharmaceuticals Inc.	/etf/ea/ETZCW.djhtm?c=1&etfid=REGN.US&back=SPLG
OXY	Occidental Petroleum Corporation	/etf/ea/ETZCW.djhtm?c=1&etfid=OXY.US&back=SPLG
TFC	Truist Financial Corporation	/etf/ea/ETZCW.djhtm?c=1&etfid=TFC.US&back=SPLG
USB	U.S. Bancorp	/etf/ea/ETZCW.djhtm?c=1&etfid=USB.US&back=SPLG
HUM	Humana Inc.	/etf/ea/ETZCW.djhtm?c=1&etfid=HUM.US&back=SPLG
LRCX	Lam Research Corporation	/etf/ea/ETZCW.djhtm?c=1&etfid=LRCX.US&back=SPLG
ATVI	Activision Blizzard Inc.	/etf/ea/ETZCW.djhtm?c=1&etfid=ATVI.US&back=SPLG
F	Ford Motor Company	/etf/ea/ETZCW.djhtm?c=1&etfid=F.US&back=SPLG
EQIX	Equinix Inc.	/etf/ea/ETZCW.djhtm?c=1&etfid=EQIX.US&back=SPLG
AON	Aon Plc Class A	/etf/ea/ETZCW.djhtm?c=1&etfid=AON.US&back=SPLG
FISV	Fiserv Inc.	/etf/ea/ETZCW.djhtm?c=1&etfid=FISV.US&back=SPLG
EL	Estee Lauder Companies Inc. Class A	/etf/ea/ETZCW.djhtm?c=1&etfid=EL.US&back=SPLG
NSC	Norfolk Southern Corporation	/etf/ea/ETZCW.djhtm?c=1&etfid=NSC.US&back=SPLG
PXD	Pioneer Natural Resources Company	/etf/ea/ETZCW.djhtm?c=1&etfid=PXD.US&back=SPLG
BSX	Boston Scientific Corporation	/etf/ea/ETZCW.djhtm?c=1&etfid=BSX.US&back=SPLG
ICE	Intercontinental Exchange Inc.	/etf/ea/ETZCW.djhtm?c=1&etfid=ICE.US&back=SPLG
EW	Edwards Lifesciences Corporation	/etf/ea/ETZCW.djhtm?c=1&etfid=EW.US&back=SPLG
SHW	Sherwin-Williams Company	/etf/ea/ETZCW.djhtm?c=1&etfid=SHW.US&back=SPLG
ITW	Illinois Tool Works Inc.	/etf/ea/ETZCW.djhtm?c=1&etfid=ITW.US&back=SPLG
APD	Air Products and Chemicals Inc.	/etf/ea/ETZCW.djhtm?c=1&etfid=APD.US&back=SPLG
FIS	Fidelity National Information Services Inc.	/etf/ea/ETZCW.djhtm?c=1&etfid=FIS.US&back=SPLG
GM	General Motors Company	/etf/ea/ETZCW.djhtm?c=1&etfid=GM.US&back=SPLG
MPC	Marathon Petroleum Corporation	/etf/ea/ETZCW.djhtm?c=1&etfid=MPC.US&back=SPLG
DG	Dollar General Corporation	/etf/ea/ETZCW.djhtm?c=1&etfid=DG.US&back=SPLG
ETN	Eaton Corp. Plc	/etf/ea/ETZCW.djhtm?c=1&etfid=ETN.US&back=SPLG
SLB	Schlumberger NV	/etf/ea/ETZCW.djhtm?c=1&etfid=SLB.US&back=SPLG
MCK	McKesson Corporation	/etf/ea/ETZCW.djhtm?c=1&etfid=MCK.US&back=SPLG
SNPS	Synopsys Inc.	/etf/ea/ETZCW.djhtm?c=1&etfid=SNPS.US&back=SPLG
GD	General Dynamics Corporation	/etf/ea/ETZCW.djhtm?c=1&etfid=GD.US&back=SPLG
CNC	Centene Corporation	/etf/ea/ETZCW.djhtm?c=1&etfid=CNC.US&back=SPLG
SRE	Sempra Energy	/etf/ea/ETZCW.djhtm?c=1&etfid=SRE.US&back=SPLG
AEP	American Electric Power Company Inc.	/etf/ea/ETZCW.djhtm?c=1&etfid=AEP.US&back=SPLG
KLAC	KLA Corporation	/etf/ea/ETZCW.djhtm?c=1&etfid=KLAC.US&back=SPLG
PSA	Public Storage	/etf/ea/ETZCW.djhtm?c=1&etfid=PSA.US&back=SPLG
FDX	FedEx Corporation	/etf/ea/ETZCW.djhtm?c=1&etfid=FDX.US&back=SPLG
ADM	Archer-Daniels-Midland Company	/etf/ea/ETZCW.djhtm?c=1&etfid=ADM.US&back=SPLG
EMR	Emerson Electric Co.	/etf/ea/ETZCW.djhtm?c=1&etfid=EMR.US&back=SPLG
CDNS	Cadence Design Systems Inc.	/etf/ea/ETZCW.djhtm?c=1&etfid=CDNS.US&back=SPLG
CHTR	Charter Communications Inc. Class A	/etf/ea/ETZCW.djhtm?c=1&etfid=CHTR.US&back=SPLG
VLO	Valero Energy Corporation	/etf/ea/ETZCW.djhtm?c=1&etfid=VLO.US&back=SPLG
GIS	General Mills Inc.	/etf/ea/ETZCW.djhtm?c=1&etfid=GIS.US&back=SPLG
ORLY	O'Reilly Automotive Inc.	/etf/ea/ETZCW.djhtm?c=1&etfid=ORLY.US&back=SPLG
MRNA	Moderna Inc.	/etf/ea/ETZCW.djhtm?c=1&etfid=MRNA.US&back=SPLG
MCO	Moody's Corporation	/etf/ea/ETZCW.djhtm?c=1&etfid=MCO.US&back=SPLG
HCA	HCA Healthcare Inc	/etf/ea/ETZCW.djhtm?c=1&etfid=HCA.US&back=SPLG
CMG	Chipotle Mexican Grill Inc.	/etf/ea/ETZCW.djhtm?c=1&etfid=CMG.US&back=SPLG
CTVA	Corteva Inc	/etf/ea/ETZCW.djhtm?c=1&etfid=CTVA.US&back=SPLG
MET	MetLife Inc.	/etf/ea/ETZCW.djhtm?c=1&etfid=MET.US&back=SPLG
ADSK	Autodesk Inc.	/etf/ea/ETZCW.djhtm?c=1&etfid=ADSK.US&back=SPLG
LHX	L3Harris Technologies Inc	/etf/ea/ETZCW.djhtm?c=1&etfid=LHX.US&back=SPLG
APH	Amphenol Corporation Class A	/etf/ea/ETZCW.djhtm?c=1&etfid=APH.US&back=SPLG
DVN	Devon Energy Corporation	/etf/ea/ETZCW.djhtm?c=1&etfid=DVN.US&back=SPLG
NXPI	NXP Semiconductors NV	/etf/ea/ETZCW.djhtm?c=1&etfid=NXPI.US&back=SPLG
FCX	Freeport-McMoRan Inc.	/etf/ea/ETZCW.djhtm?c=1&etfid=FCX.US&back=SPLG
EXC	Exelon Corporation	/etf/ea/ETZCW.djhtm?c=1&etfid=EXC.US&back=SPLG
KMB	Kimberly-Clark Corporation	/etf/ea/ETZCW.djhtm?c=1&etfid=KMB.US&back=SPLG
ROP	Roper Technologies Inc.	/etf/ea/ETZCW.djhtm?c=1&etfid=ROP.US&back=SPLG
PSX	Phillips 66	/etf/ea/ETZCW.djhtm?c=1&etfid=PSX.US&back=SPLG
MAR	Marriott International Inc. Class A	/etf/ea/ETZCW.djhtm?c=1&etfid=MAR.US&back=SPLG
SYY	Sysco Corporation	/etf/ea/ETZCW.djhtm?c=1&etfid=SYY.US&back=SPLG
AZO	AutoZone Inc.	/etf/ea/ETZCW.djhtm?c=1&etfid=AZO.US&back=SPLG
COF	Capital One Financial Corp	/etf/ea/ETZCW.djhtm?c=1&etfid=COF.US&back=SPLG
WMB	Williams Companies Inc.	/etf/ea/ETZCW.djhtm?c=1&etfid=WMB.US&back=SPLG
O	Realty Income Corporation	/etf/ea/ETZCW.djhtm?c=1&etfid=O.US&back=SPLG
MSI	Motorola Solutions Inc.	/etf/ea/ETZCW.djhtm?c=1&etfid=MSI.US&back=SPLG
AIG	American International Group Inc.	/etf/ea/ETZCW.djhtm?c=1&etfid=AIG.US&back=SPLG
TEL	TE Connectivity Ltd.	/etf/ea/ETZCW.djhtm?c=1&etfid=TEL.US&back=SPLG
ECL	Ecolab Inc.	/etf/ea/ETZCW.djhtm?c=1&etfid=ECL.US&back=SPLG
XEL	Xcel Energy Inc.	/etf/ea/ETZCW.djhtm?c=1&etfid=XEL.US&back=SPLG
IQV	IQVIA Holdings Inc	/etf/ea/ETZCW.djhtm?c=1&etfid=IQV.US&back=SPLG
STZ	Constellation Brands Inc. Class A	/etf/ea/ETZCW.djhtm?c=1&etfid=STZ.US&back=SPLG
PAYX	Paychex Inc.	/etf/ea/ETZCW.djhtm?c=1&etfid=PAYX.US&back=SPLG
TRV	Travelers Companies Inc.	/etf/ea/ETZCW.djhtm?c=1&etfid=TRV.US&back=SPLG
A	Agilent Technologies Inc.	/etf/ea/ETZCW.djhtm?c=1&etfid=A.US&back=SPLG
ENPH	Enphase Energy Inc.	/etf/ea/ETZCW.djhtm?c=1&etfid=ENPH.US&back=SPLG
AJG	Arthur J. Gallagher & Co.	/etf/ea/ETZCW.djhtm?c=1&etfid=AJG.US&back=SPLG
JCI	Johnson Controls International plc	/etf/ea/ETZCW.djhtm?c=1&etfid=JCI.US&back=SPLG
DOW	Dow Inc.	/etf/ea/ETZCW.djhtm?c=1&etfid=DOW.US&back=SPLG
MSCI	MSCI Inc. Class A	/etf/ea/ETZCW.djhtm?c=1&etfid=MSCI.US&back=SPLG
MCHP	Microchip Technology Incorporated	/etf/ea/ETZCW.djhtm?c=1&etfid=MCHP.US&back=SPLG
PRU	Prudential Financial Inc.	/etf/ea/ETZCW.djhtm?c=1&etfid=PRU.US&back=SPLG
TT	Trane Technologies plc	/etf/ea/ETZCW.djhtm?c=1&etfid=TT.US&back=SPLG
EA	Electronic Arts Inc.	/etf/ea/ETZCW.djhtm?c=1&etfid=EA.US&back=SPLG
KMI	Kinder Morgan Inc Class P	/etf/ea/ETZCW.djhtm?c=1&etfid=KMI.US&back=SPLG
CTAS	Cintas Corporation	/etf/ea/ETZCW.djhtm?c=1&etfid=CTAS.US&back=SPLG
NUE	Nucor Corporation	/etf/ea/ETZCW.djhtm?c=1&etfid=NUE.US&back=SPLG
GPN	Global Payments Inc.	/etf/ea/ETZCW.djhtm?c=1&etfid=GPN.US&back=SPLG
SBAC	SBA Communications Corp. Class A	/etf/ea/ETZCW.djhtm?c=1&etfid=SBAC.US&back=SPLG
AFL	Aflac Incorporated	/etf/ea/ETZCW.djhtm?c=1&etfid=AFL.US&back=SPLG
HLT	Hilton Worldwide Holdings Inc	/etf/ea/ETZCW.djhtm?c=1&etfid=HLT.US&back=SPLG
DLR	Digital Realty Trust Inc.	/etf/ea/ETZCW.djhtm?c=1&etfid=DLR.US&back=SPLG
WELL	Welltower Inc	/etf/ea/ETZCW.djhtm?c=1&etfid=WELL.US&back=SPLG
ED	Consolidated Edison Inc.	/etf/ea/ETZCW.djhtm?c=1&etfid=ED.US&back=SPLG
PH	Parker-Hannifin Corporation	/etf/ea/ETZCW.djhtm?c=1&etfid=PH.US&back=SPLG
SPG	Simon Property Group Inc.	/etf/ea/ETZCW.djhtm?c=1&etfid=SPG.US&back=SPLG
CARR	Carrier Global Corp.	/etf/ea/ETZCW.djhtm?c=1&etfid=CARR.US&back=SPLG
MNST	Monster Beverage Corporation	/etf/ea/ETZCW.djhtm?c=1&etfid=MNST.US&back=SPLG
ALL	Allstate Corporation	/etf/ea/ETZCW.djhtm?c=1&etfid=ALL.US&back=SPLG
HES	Hess Corporation	/etf/ea/ETZCW.djhtm?c=1&etfid=HES.US&back=SPLG
CTSH	Cognizant Technology Solutions Corporation Class A	/etf/ea/ETZCW.djhtm?c=1&etfid=CTSH.US&back=SPLG
NEM	Newmont Corporation	/etf/ea/ETZCW.djhtm?c=1&etfid=NEM.US&back=SPLG
HSY	Hershey Company	/etf/ea/ETZCW.djhtm?c=1&etfid=HSY.US&back=SPLG
FTNT	Fortinet Inc.	/etf/ea/ETZCW.djhtm?c=1&etfid=FTNT.US&back=SPLG
PEG	Public Service Enterprise Group Inc	/etf/ea/ETZCW.djhtm?c=1&etfid=PEG.US&back=SPLG
WEC	WEC Energy Group Inc	/etf/ea/ETZCW.djhtm?c=1&etfid=WEC.US&back=SPLG
MTB	M&T Bank Corporation	/etf/ea/ETZCW.djhtm?c=1&etfid=MTB.US&back=SPLG
DXCM	DexCom Inc.	/etf/ea/ETZCW.djhtm?c=1&etfid=DXCM.US&back=SPLG
RMD	ResMed Inc.	/etf/ea/ETZCW.djhtm?c=1&etfid=RMD.US&back=SPLG
VICI	VICI Properties Inc	/etf/ea/ETZCW.djhtm?c=1&etfid=VICI.US&back=SPLG
YUM	Yum! Brands Inc.	/etf/ea/ETZCW.djhtm?c=1&etfid=YUM.US&back=SPLG
KR	Kroger Co.	/etf/ea/ETZCW.djhtm?c=1&etfid=KR.US&back=SPLG
ILMN	Illumina Inc.	/etf/ea/ETZCW.djhtm?c=1&etfid=ILMN.US&back=SPLG
TDG	TransDigm Group Incorporated	/etf/ea/ETZCW.djhtm?c=1&etfid=TDG.US&back=SPLG
ALB	Albemarle Corporation	/etf/ea/ETZCW.djhtm?c=1&etfid=ALB.US&back=SPLG
ES	Eversource Energy	/etf/ea/ETZCW.djhtm?c=1&etfid=ES.US&back=SPLG
BK	Bank of New York Mellon Corp	/etf/ea/ETZCW.djhtm?c=1&etfid=BK.US&back=SPLG
OTIS	Otis Worldwide Corporation	/etf/ea/ETZCW.djhtm?c=1&etfid=OTIS.US&back=SPLG
DLTR	Dollar Tree Inc.	/etf/ea/ETZCW.djhtm?c=1&etfid=DLTR.US&back=SPLG
ROST	Ross Stores Inc.	/etf/ea/ETZCW.djhtm?c=1&etfid=ROST.US&back=SPLG
CMI	Cummins Inc.	/etf/ea/ETZCW.djhtm?c=1&etfid=CMI.US&back=SPLG
PCAR	PACCAR Inc	/etf/ea/ETZCW.djhtm?c=1&etfid=PCAR.US&back=SPLG
HPQ	HP Inc.	/etf/ea/ETZCW.djhtm?c=1&etfid=HPQ.US&back=SPLG
KEYS	Keysight Technologies Inc	/etf/ea/ETZCW.djhtm?c=1&etfid=KEYS.US&back=SPLG
ON	ON Semiconductor Corporation	/etf/ea/ETZCW.djhtm?c=1&etfid=ON.US&back=SPLG
AMP	Ameriprise Financial Inc.	/etf/ea/ETZCW.djhtm?c=1&etfid=AMP.US&back=SPLG
PPG	PPG Industries Inc.	/etf/ea/ETZCW.djhtm?c=1&etfid=PPG.US&back=SPLG
RSG	Republic Services Inc.	/etf/ea/ETZCW.djhtm?c=1&etfid=RSG.US&back=SPLG
VRSK	Verisk Analytics Inc	/etf/ea/ETZCW.djhtm?c=1&etfid=VRSK.US&back=SPLG
TWTR	Twitter Inc.	/etf/ea/ETZCW.djhtm?c=1&etfid=TWTR.US&back=SPLG
IDXX	IDEXX Laboratories Inc.	/etf/ea/ETZCW.djhtm?c=1&etfid=IDXX.US&back=SPLG
WBD	Warner Bros. Discovery Inc. Series A	/etf/ea/ETZCW.djhtm?c=1&etfid=WBD.US&back=SPLG
FAST	Fastenal Company	/etf/ea/ETZCW.djhtm?c=1&etfid=FAST.US&back=SPLG
BAX	Baxter International Inc.	/etf/ea/ETZCW.djhtm?c=1&etfid=BAX.US&back=SPLG
BIIB	Biogen Inc.	/etf/ea/ETZCW.djhtm?c=1&etfid=BIIB.US&back=SPLG
DD	DuPont de Nemours Inc.	/etf/ea/ETZCW.djhtm?c=1&etfid=DD.US&back=SPLG
DFS	Discover Financial Services	/etf/ea/ETZCW.djhtm?c=1&etfid=DFS.US&back=SPLG
MTD	Mettler-Toledo International Inc.	/etf/ea/ETZCW.djhtm?c=1&etfid=MTD.US&back=SPLG
KDP	Keurig Dr Pepper Inc.	/etf/ea/ETZCW.djhtm?c=1&etfid=KDP.US&back=SPLG
AVB	AvalonBay Communities Inc.	/etf/ea/ETZCW.djhtm?c=1&etfid=AVB.US&back=SPLG
IFF	International Flavors & Fragrances Inc.	/etf/ea/ETZCW.djhtm?c=1&etfid=IFF.US&back=SPLG
AME	AMETEK Inc.	/etf/ea/ETZCW.djhtm?c=1&etfid=AME.US&back=SPLG
ROK	Rockwell Automation Inc.	/etf/ea/ETZCW.djhtm?c=1&etfid=ROK.US&back=SPLG
OKE	ONEOK Inc.	/etf/ea/ETZCW.djhtm?c=1&etfid=OKE.US&back=SPLG
HAL	Halliburton Company	/etf/ea/ETZCW.djhtm?c=1&etfid=HAL.US&back=SPLG
AWK	American Water Works Company Inc.	/etf/ea/ETZCW.djhtm?c=1&etfid=AWK.US&back=SPLG
TROW	T. Rowe Price Group	/etf/ea/ETZCW.djhtm?c=1&etfid=TROW.US&back=SPLG
FRC	First Republic Bank	/etf/ea/ETZCW.djhtm?c=1&etfid=FRC.US&back=SPLG
ANET	Arista Networks Inc.	/etf/ea/ETZCW.djhtm?c=1&etfid=ANET.US&back=SPLG
CEG	Constellation Energy Corporation	/etf/ea/ETZCW.djhtm?c=1&etfid=CEG.US&back=SPLG
KHC	Kraft Heinz Company	/etf/ea/ETZCW.djhtm?c=1&etfid=KHC.US&back=SPLG
EXR	Extra Space Storage Inc.	/etf/ea/ETZCW.djhtm?c=1&etfid=EXR.US&back=SPLG
CBRE	CBRE Group Inc. Class A	/etf/ea/ETZCW.djhtm?c=1&etfid=CBRE.US&back=SPLG
GLW	Corning Inc	/etf/ea/ETZCW.djhtm?c=1&etfid=GLW.US&back=SPLG
EIX	Edison International	/etf/ea/ETZCW.djhtm?c=1&etfid=EIX.US&back=SPLG
WY	Weyerhaeuser Company	/etf/ea/ETZCW.djhtm?c=1&etfid=WY.US&back=SPLG
CPRT	Copart Inc.	/etf/ea/ETZCW.djhtm?c=1&etfid=CPRT.US&back=SPLG
APTV	Aptiv PLC	/etf/ea/ETZCW.djhtm?c=1&etfid=APTV.US&back=SPLG
WBA	Walgreens Boots Alliance Inc.	/etf/ea/ETZCW.djhtm?c=1&etfid=WBA.US&back=SPLG
CTRA	Coterra Energy Inc.	/etf/ea/ETZCW.djhtm?c=1&etfid=CTRA.US&back=SPLG
DTE	DTE Energy Company	/etf/ea/ETZCW.djhtm?c=1&etfid=DTE.US&back=SPLG
EQR	Equity Residential	/etf/ea/ETZCW.djhtm?c=1&etfid=EQR.US&back=SPLG
ODFL	Old Dominion Freight Line Inc.	/etf/ea/ETZCW.djhtm?c=1&etfid=ODFL.US&back=SPLG
STT	State Street Corporation	/etf/ea/ETZCW.djhtm?c=1&etfid=STT.US&back=SPLG
EBAY	eBay Inc.	/etf/ea/ETZCW.djhtm?c=1&etfid=EBAY.US&back=SPLG
EPAM	EPAM Systems Inc.	/etf/ea/ETZCW.djhtm?c=1&etfid=EPAM.US&back=SPLG
GWW	W.W. Grainger Inc.	/etf/ea/ETZCW.djhtm?c=1&etfid=GWW.US&back=SPLG
AEE	Ameren Corporation	/etf/ea/ETZCW.djhtm?c=1&etfid=AEE.US&back=SPLG
SIVB	SVB Financial Group	/etf/ea/ETZCW.djhtm?c=1&etfid=SIVB.US&back=SPLG
BKR	Baker Hughes Company Class A	/etf/ea/ETZCW.djhtm?c=1&etfid=BKR.US&back=SPLG
FITB	Fifth Third Bancorp	/etf/ea/ETZCW.djhtm?c=1&etfid=FITB.US&back=SPLG
WTW	Willis Towers Watson Public Limited Company	/etf/ea/ETZCW.djhtm?c=1&etfid=WTW.US&back=SPLG
IT	Gartner Inc.	/etf/ea/ETZCW.djhtm?c=1&etfid=IT.US&back=SPLG
ETR	Entergy Corporation	/etf/ea/ETZCW.djhtm?c=1&etfid=ETR.US&back=SPLG
CDW	CDW Corp.	/etf/ea/ETZCW.djhtm?c=1&etfid=CDW.US&back=SPLG
DHI	D.R. Horton Inc.	/etf/ea/ETZCW.djhtm?c=1&etfid=DHI.US&back=SPLG
EFX	Equifax Inc.	/etf/ea/ETZCW.djhtm?c=1&etfid=EFX.US&back=SPLG
ARE	Alexandria Real Estate Equities Inc.	/etf/ea/ETZCW.djhtm?c=1&etfid=ARE.US&back=SPLG
FE	FirstEnergy Corp.	/etf/ea/ETZCW.djhtm?c=1&etfid=FE.US&back=SPLG
FTV	Fortive Corp.	/etf/ea/ETZCW.djhtm?c=1&etfid=FTV.US&back=SPLG
	Duke Realty Corporation	
FANG	Diamondback Energy Inc.	/etf/ea/ETZCW.djhtm?c=1&etfid=FANG.US&back=SPLG
GPC	Genuine Parts Company	/etf/ea/ETZCW.djhtm?c=1&etfid=GPC.US&back=SPLG
ZBH	Zimmer Biomet Holdings Inc.	/etf/ea/ETZCW.djhtm?c=1&etfid=ZBH.US&back=SPLG
ULTA	Ulta Beauty Inc.	/etf/ea/ETZCW.djhtm?c=1&etfid=ULTA.US&back=SPLG
TSN	Tyson Foods Inc. Class A	/etf/ea/ETZCW.djhtm?c=1&etfid=TSN.US&back=SPLG
VMC	Vulcan Materials Company	/etf/ea/ETZCW.djhtm?c=1&etfid=VMC.US&back=SPLG
ABC	AmerisourceBergen Corporation	/etf/ea/ETZCW.djhtm?c=1&etfid=ABC.US&back=SPLG
WST	West Pharmaceutical Services Inc.	/etf/ea/ETZCW.djhtm?c=1&etfid=WST.US&back=SPLG
PPL	PPL Corporation	/etf/ea/ETZCW.djhtm?c=1&etfid=PPL.US&back=SPLG
LUV	Southwest Airlines Co.	/etf/ea/ETZCW.djhtm?c=1&etfid=LUV.US&back=SPLG
CF	CF Industries Holdings Inc.	/etf/ea/ETZCW.djhtm?c=1&etfid=CF.US&back=SPLG
ANSS	ANSYS Inc.	/etf/ea/ETZCW.djhtm?c=1&etfid=ANSS.US&back=SPLG
LYB	LyondellBasell Industries NV	/etf/ea/ETZCW.djhtm?c=1&etfid=LYB.US&back=SPLG
MLM	Martin Marietta Materials Inc.	/etf/ea/ETZCW.djhtm?c=1&etfid=MLM.US&back=SPLG
HIG	Hartford Financial Services Group Inc.	/etf/ea/ETZCW.djhtm?c=1&etfid=HIG.US&back=SPLG
TSCO	Tractor Supply Company	/etf/ea/ETZCW.djhtm?c=1&etfid=TSCO.US&back=SPLG
URI	United Rentals Inc.	/etf/ea/ETZCW.djhtm?c=1&etfid=URI.US&back=SPLG
LH	Laboratory Corporation of America Holdings	/etf/ea/ETZCW.djhtm?c=1&etfid=LH.US&back=SPLG
MKC	McCormick & Company Incorporated	/etf/ea/ETZCW.djhtm?c=1&etfid=MKC.US&back=SPLG
NDAQ	Nasdaq Inc.	/etf/ea/ETZCW.djhtm?c=1&etfid=NDAQ.US&back=SPLG
RF	Regions Financial Corporation	/etf/ea/ETZCW.djhtm?c=1&etfid=RF.US&back=SPLG
RJF	Raymond James Financial Inc.	/etf/ea/ETZCW.djhtm?c=1&etfid=RJF.US&back=SPLG
CHD	Church & Dwight Co. Inc.	/etf/ea/ETZCW.djhtm?c=1&etfid=CHD.US&back=SPLG
LEN	Lennar Corporation Class A	/etf/ea/ETZCW.djhtm?c=1&etfid=LEN.US&back=SPLG
PWR	Quanta Services Inc.	/etf/ea/ETZCW.djhtm?c=1&etfid=PWR.US&back=SPLG
STE	STERIS Plc	/etf/ea/ETZCW.djhtm?c=1&etfid=STE.US&back=SPLG
BR	Broadridge Financial Solutions Inc.	/etf/ea/ETZCW.djhtm?c=1&etfid=BR.US&back=SPLG
DAL	Delta Air Lines Inc.	/etf/ea/ETZCW.djhtm?c=1&etfid=DAL.US&back=SPLG
CNP	CenterPoint Energy Inc.	/etf/ea/ETZCW.djhtm?c=1&etfid=CNP.US&back=SPLG
NTRS	Northern Trust Corporation	/etf/ea/ETZCW.djhtm?c=1&etfid=NTRS.US&back=SPLG
CAH	Cardinal Health Inc.	/etf/ea/ETZCW.djhtm?c=1&etfid=CAH.US&back=SPLG
MOH	Molina Healthcare Inc.	/etf/ea/ETZCW.djhtm?c=1&etfid=MOH.US&back=SPLG
MOS	Mosaic Company	/etf/ea/ETZCW.djhtm?c=1&etfid=MOS.US&back=SPLG
MPWR	Monolithic Power Systems Inc.	/etf/ea/ETZCW.djhtm?c=1&etfid=MPWR.US&back=SPLG
CMS	CMS Energy Corporation	/etf/ea/ETZCW.djhtm?c=1&etfid=CMS.US&back=SPLG
TTWO	Take-Two Interactive Software Inc.	/etf/ea/ETZCW.djhtm?c=1&etfid=TTWO.US&back=SPLG
HBAN	Huntington Bancshares Incorporated	/etf/ea/ETZCW.djhtm?c=1&etfid=HBAN.US&back=SPLG
IR	Ingersoll Rand Inc.	/etf/ea/ETZCW.djhtm?c=1&etfid=IR.US&back=SPLG
VTR	Ventas Inc.	/etf/ea/ETZCW.djhtm?c=1&etfid=VTR.US&back=SPLG
MAA	Mid-America Apartment Communities Inc.	/etf/ea/ETZCW.djhtm?c=1&etfid=MAA.US&back=SPLG
K	Kellogg Company	/etf/ea/ETZCW.djhtm?c=1&etfid=K.US&back=SPLG
AMCR	Amcor PLC	/etf/ea/ETZCW.djhtm?c=1&etfid=AMCR.US&back=SPLG
MRO	Marathon Oil Corporation	/etf/ea/ETZCW.djhtm?c=1&etfid=MRO.US&back=SPLG
CFG	Citizens Financial Group Inc.	/etf/ea/ETZCW.djhtm?c=1&etfid=CFG.US&back=SPLG
WAT	Waters Corporation	/etf/ea/ETZCW.djhtm?c=1&etfid=WAT.US&back=SPLG
BALL	Ball Corporation	/etf/ea/ETZCW.djhtm?c=1&etfid=BALL.US&back=SPLG
DOV	Dover Corporation	/etf/ea/ETZCW.djhtm?c=1&etfid=DOV.US&back=SPLG
CLX	Clorox Company	/etf/ea/ETZCW.djhtm?c=1&etfid=CLX.US&back=SPLG
ALGN	Align Technology Inc.	/etf/ea/ETZCW.djhtm?c=1&etfid=ALGN.US&back=SPLG
HPE	Hewlett Packard Enterprise Co.	/etf/ea/ETZCW.djhtm?c=1&etfid=HPE.US&back=SPLG
VRSN	VeriSign Inc.	/etf/ea/ETZCW.djhtm?c=1&etfid=VRSN.US&back=SPLG
PFG	Principal Financial Group Inc.	/etf/ea/ETZCW.djhtm?c=1&etfid=PFG.US&back=SPLG
ESS	Essex Property Trust Inc.	/etf/ea/ETZCW.djhtm?c=1&etfid=ESS.US&back=SPLG
EXPD	Expeditors International of Washington Inc.	/etf/ea/ETZCW.djhtm?c=1&etfid=EXPD.US&back=SPLG
PKI	PerkinElmer Inc.	/etf/ea/ETZCW.djhtm?c=1&etfid=PKI.US&back=SPLG
TDY	Teledyne Technologies Incorporated	/etf/ea/ETZCW.djhtm?c=1&etfid=TDY.US&back=SPLG
AES	AES Corporation	/etf/ea/ETZCW.djhtm?c=1&etfid=AES.US&back=SPLG
HOLX	Hologic Inc.	/etf/ea/ETZCW.djhtm?c=1&etfid=HOLX.US&back=SPLG
FDS	FactSet Research Systems Inc.	/etf/ea/ETZCW.djhtm?c=1&etfid=FDS.US&back=SPLG
PAYC	Paycom Software Inc.	/etf/ea/ETZCW.djhtm?c=1&etfid=PAYC.US&back=SPLG
SYF	Synchrony Financial	/etf/ea/ETZCW.djhtm?c=1&etfid=SYF.US&back=SPLG
KEY	KeyCorp	/etf/ea/ETZCW.djhtm?c=1&etfid=KEY.US&back=SPLG
XYL	Xylem Inc.	/etf/ea/ETZCW.djhtm?c=1&etfid=XYL.US&back=SPLG
CAG	Conagra Brands Inc.	/etf/ea/ETZCW.djhtm?c=1&etfid=CAG.US&back=SPLG
FLT	FLEETCOR Technologies Inc.	/etf/ea/ETZCW.djhtm?c=1&etfid=FLT.US&back=SPLG
WAB	Westinghouse Air Brake Technologies Corporation	/etf/ea/ETZCW.djhtm?c=1&etfid=WAB.US&back=SPLG
ZBRA	Zebra Technologies Corporation Class A	/etf/ea/ETZCW.djhtm?c=1&etfid=ZBRA.US&back=SPLG
J	Jacobs Solutions Inc.	/etf/ea/ETZCW.djhtm?c=1&etfid=J.US&back=SPLG
SWKS	Skyworks Solutions Inc.	/etf/ea/ETZCW.djhtm?c=1&etfid=SWKS.US&back=SPLG
NTAP	NetApp Inc.	/etf/ea/ETZCW.djhtm?c=1&etfid=NTAP.US&back=SPLG
MTCH	Match Group Inc.	/etf/ea/ETZCW.djhtm?c=1&etfid=MTCH.US&back=SPLG
EXPE	Expedia Group Inc.	/etf/ea/ETZCW.djhtm?c=1&etfid=EXPE.US&back=SPLG
TRMB	Trimble Inc.	/etf/ea/ETZCW.djhtm?c=1&etfid=TRMB.US&back=SPLG
ATO	Atmos Energy Corporation	/etf/ea/ETZCW.djhtm?c=1&etfid=ATO.US&back=SPLG
CTLT	Catalent Inc	/etf/ea/ETZCW.djhtm?c=1&etfid=CTLT.US&back=SPLG
EVRG	Evergy Inc.	/etf/ea/ETZCW.djhtm?c=1&etfid=EVRG.US&back=SPLG
DRI	Darden Restaurants Inc.	/etf/ea/ETZCW.djhtm?c=1&etfid=DRI.US&back=SPLG
IP	International Paper Company	/etf/ea/ETZCW.djhtm?c=1&etfid=IP.US&back=SPLG
TYL	Tyler Technologies Inc.	/etf/ea/ETZCW.djhtm?c=1&etfid=TYL.US&back=SPLG
SJM	J.M. Smucker Company	/etf/ea/ETZCW.djhtm?c=1&etfid=SJM.US&back=SPLG
SEDG	SolarEdge Technologies Inc.	/etf/ea/ETZCW.djhtm?c=1&etfid=SEDG.US&back=SPLG
AVY	Avery Dennison Corporation	/etf/ea/ETZCW.djhtm?c=1&etfid=AVY.US&back=SPLG
LNT	Alliant Energy Corp	/etf/ea/ETZCW.djhtm?c=1&etfid=LNT.US&back=SPLG
IRM	Iron Mountain Inc.	/etf/ea/ETZCW.djhtm?c=1&etfid=IRM.US&back=SPLG
IEX	IDEX Corporation	/etf/ea/ETZCW.djhtm?c=1&etfid=IEX.US&back=SPLG
DGX	Quest Diagnostics Incorporated	/etf/ea/ETZCW.djhtm?c=1&etfid=DGX.US&back=SPLG
CHRW	C.H. Robinson Worldwide Inc.	/etf/ea/ETZCW.djhtm?c=1&etfid=CHRW.US&back=SPLG
JBHT	J.B. Hunt Transport Services Inc.	/etf/ea/ETZCW.djhtm?c=1&etfid=JBHT.US&back=SPLG
BRO	Brown & Brown Inc.	/etf/ea/ETZCW.djhtm?c=1&etfid=BRO.US&back=SPLG
AKAM	Akamai Technologies Inc.	/etf/ea/ETZCW.djhtm?c=1&etfid=AKAM.US&back=SPLG
CINF	Cincinnati Financial Corporation	/etf/ea/ETZCW.djhtm?c=1&etfid=CINF.US&back=SPLG
BBY	Best Buy Co. Inc.	/etf/ea/ETZCW.djhtm?c=1&etfid=BBY.US&back=SPLG
KMX	CarMax Inc.	/etf/ea/ETZCW.djhtm?c=1&etfid=KMX.US&back=SPLG
HRL	Hormel Foods Corporation	/etf/ea/ETZCW.djhtm?c=1&etfid=HRL.US&back=SPLG
PARA	Paramount Global Class B	/etf/ea/ETZCW.djhtm?c=1&etfid=PARA.US&back=SPLG
PEAK	Healthpeak Properties Inc.	/etf/ea/ETZCW.djhtm?c=1&etfid=PEAK.US&back=SPLG
JKHY	Jack Henry & Associates Inc.	/etf/ea/ETZCW.djhtm?c=1&etfid=JKHY.US&back=SPLG
OMC	Omnicom Group Inc	/etf/ea/ETZCW.djhtm?c=1&etfid=OMC.US&back=SPLG
DPZ	Domino's Pizza Inc.	/etf/ea/ETZCW.djhtm?c=1&etfid=DPZ.US&back=SPLG
LKQ	LKQ Corporation	/etf/ea/ETZCW.djhtm?c=1&etfid=LKQ.US&back=SPLG
COO	Cooper Companies Inc.	/etf/ea/ETZCW.djhtm?c=1&etfid=COO.US&back=SPLG
POOL	Pool Corporation	/etf/ea/ETZCW.djhtm?c=1&etfid=POOL.US&back=SPLG
FMC	FMC Corporation	/etf/ea/ETZCW.djhtm?c=1&etfid=FMC.US&back=SPLG
CPT	Camden Property Trust	/etf/ea/ETZCW.djhtm?c=1&etfid=CPT.US&back=SPLG
TER	Teradyne Inc.	/etf/ea/ETZCW.djhtm?c=1&etfid=TER.US&back=SPLG
GNRC	Generac Holdings Inc.	/etf/ea/ETZCW.djhtm?c=1&etfid=GNRC.US&back=SPLG
TXT	Textron Inc.	/etf/ea/ETZCW.djhtm?c=1&etfid=TXT.US&back=SPLG
WRB	W. R. Berkley Corporation	/etf/ea/ETZCW.djhtm?c=1&etfid=WRB.US&back=SPLG
HWM	Howmet Aerospace Inc.	/etf/ea/ETZCW.djhtm?c=1&etfid=HWM.US&back=SPLG
GRMN	Garmin Ltd.	/etf/ea/ETZCW.djhtm?c=1&etfid=GRMN.US&back=SPLG
STX	Seagate Technology Holdings PLC	/etf/ea/ETZCW.djhtm?c=1&etfid=STX.US&back=SPLG
VFC	V.F. Corporation	/etf/ea/ETZCW.djhtm?c=1&etfid=VFC.US&back=SPLG
ETSY	Etsy Inc.	/etf/ea/ETZCW.djhtm?c=1&etfid=ETSY.US&back=SPLG
BF.B	Brown-Forman Corporation Class B	/etf/ea/ETZCW.djhtm?c=1&etfid=BF.B.US&back=SPLG
SWK	Stanley Black & Decker Inc.	/etf/ea/ETZCW.djhtm?c=1&etfid=SWK.US&back=SPLG
APA	APA Corp.	/etf/ea/ETZCW.djhtm?c=1&etfid=APA.US&back=SPLG
TECH	Bio-Techne Corporation	/etf/ea/ETZCW.djhtm?c=1&etfid=TECH.US&back=SPLG
WDC	Western Digital Corporation	/etf/ea/ETZCW.djhtm?c=1&etfid=WDC.US&back=SPLG
INCY	Incyte Corporation	/etf/ea/ETZCW.djhtm?c=1&etfid=INCY.US&back=SPLG
PKG	Packaging Corporation of America	/etf/ea/ETZCW.djhtm?c=1&etfid=PKG.US&back=SPLG
NLOK	NortonLifeLock Inc.	/etf/ea/ETZCW.djhtm?c=1&etfid=NLOK.US&back=SPLG
UDR	UDR Inc.	/etf/ea/ETZCW.djhtm?c=1&etfid=UDR.US&back=SPLG
LDOS	Leidos Holdings Inc.	/etf/ea/ETZCW.djhtm?c=1&etfid=LDOS.US&back=SPLG
KIM	Kimco Realty Corporation	/etf/ea/ETZCW.djhtm?c=1&etfid=KIM.US&back=SPLG
LVS	Las Vegas Sands Corp.	/etf/ea/ETZCW.djhtm?c=1&etfid=LVS.US&back=SPLG
	Citrix Systems Inc.	
NVR	NVR Inc.	/etf/ea/ETZCW.djhtm?c=1&etfid=NVR.US&back=SPLG
HST	Host Hotels & Resorts Inc.	/etf/ea/ETZCW.djhtm?c=1&etfid=HST.US&back=SPLG
CBOE	Cboe Global Markets Inc	/etf/ea/ETZCW.djhtm?c=1&etfid=CBOE.US&back=SPLG
NDSN	Nordson Corporation	/etf/ea/ETZCW.djhtm?c=1&etfid=NDSN.US&back=SPLG
LYV	Live Nation Entertainment Inc.	/etf/ea/ETZCW.djhtm?c=1&etfid=LYV.US&back=SPLG
CE	Celanese Corporation	/etf/ea/ETZCW.djhtm?c=1&etfid=CE.US&back=SPLG
MAS	Masco Corporation	/etf/ea/ETZCW.djhtm?c=1&etfid=MAS.US&back=SPLG
PTC	PTC Inc.	/etf/ea/ETZCW.djhtm?c=1&etfid=PTC.US&back=SPLG
SNA	Snap-on Incorporated	/etf/ea/ETZCW.djhtm?c=1&etfid=SNA.US&back=SPLG
ABMD	ABIOMED Inc.	/etf/ea/ETZCW.djhtm?c=1&etfid=ABMD.US&back=SPLG
EMN	Eastman Chemical Company	/etf/ea/ETZCW.djhtm?c=1&etfid=EMN.US&back=SPLG
MGM	MGM Resorts International	/etf/ea/ETZCW.djhtm?c=1&etfid=MGM.US&back=SPLG
NI	NiSource Inc	/etf/ea/ETZCW.djhtm?c=1&etfid=NI.US&back=SPLG
LW	Lamb Weston Holdings Inc.	/etf/ea/ETZCW.djhtm?c=1&etfid=LW.US&back=SPLG
VTRS	Viatris Inc.	/etf/ea/ETZCW.djhtm?c=1&etfid=VTRS.US&back=SPLG
BXP	Boston Properties Inc.	/etf/ea/ETZCW.djhtm?c=1&etfid=BXP.US&back=SPLG
UAL	United Airlines Holdings Inc.	/etf/ea/ETZCW.djhtm?c=1&etfid=UAL.US&back=SPLG
SBNY	Signature Bank	/etf/ea/ETZCW.djhtm?c=1&etfid=SBNY.US&back=SPLG
FOXA	Fox Corporation Class A	/etf/ea/ETZCW.djhtm?c=1&etfid=FOXA.US&back=SPLG
L	Loews Corporation	/etf/ea/ETZCW.djhtm?c=1&etfid=L.US&back=SPLG
IPG	Interpublic Group of Companies Inc.	/etf/ea/ETZCW.djhtm?c=1&etfid=IPG.US&back=SPLG
RE	Everest Re Group Ltd.	/etf/ea/ETZCW.djhtm?c=1&etfid=RE.US&back=SPLG
CMA	Comerica Incorporated	/etf/ea/ETZCW.djhtm?c=1&etfid=CMA.US&back=SPLG
BIO	Bio-Rad Laboratories Inc. Class A	/etf/ea/ETZCW.djhtm?c=1&etfid=BIO.US&back=SPLG
AAP	Advance Auto Parts Inc.	/etf/ea/ETZCW.djhtm?c=1&etfid=AAP.US&back=SPLG
TFX	Teleflex Incorporated	/etf/ea/ETZCW.djhtm?c=1&etfid=TFX.US&back=SPLG
WRK	WestRock Company	/etf/ea/ETZCW.djhtm?c=1&etfid=WRK.US&back=SPLG
CRL	Charles River Laboratories International Inc.	/etf/ea/ETZCW.djhtm?c=1&etfid=CRL.US&back=SPLG
HSIC	Henry Schein Inc.	/etf/ea/ETZCW.djhtm?c=1&etfid=HSIC.US&back=SPLG
HAS	Hasbro Inc.	/etf/ea/ETZCW.djhtm?c=1&etfid=HAS.US&back=SPLG
CPB	Campbell Soup Company	/etf/ea/ETZCW.djhtm?c=1&etfid=CPB.US&back=SPLG
NRG	NRG Energy Inc.	/etf/ea/ETZCW.djhtm?c=1&etfid=NRG.US&back=SPLG
NLSN	Nielsen Holdings Plc	/etf/ea/ETZCW.djhtm?c=1&etfid=NLSN.US&back=SPLG
QRVO	Qorvo Inc.	/etf/ea/ETZCW.djhtm?c=1&etfid=QRVO.US&back=SPLG
PHM	PulteGroup Inc.	/etf/ea/ETZCW.djhtm?c=1&etfid=PHM.US&back=SPLG
TAP	Molson Coors Beverage Company Class B	/etf/ea/ETZCW.djhtm?c=1&etfid=TAP.US&back=SPLG
MKTX	MarketAxess Holdings Inc.	/etf/ea/ETZCW.djhtm?c=1&etfid=MKTX.US&back=SPLG
FFIV	F5 Inc.	/etf/ea/ETZCW.djhtm?c=1&etfid=FFIV.US&back=SPLG
HII	Huntington Ingalls Industries Inc.	/etf/ea/ETZCW.djhtm?c=1&etfid=HII.US&back=SPLG
REG	Regency Centers Corporation	/etf/ea/ETZCW.djhtm?c=1&etfid=REG.US&back=SPLG
CCL	Carnival Corporation	/etf/ea/ETZCW.djhtm?c=1&etfid=CCL.US&back=SPLG
JNPR	Juniper Networks Inc.	/etf/ea/ETZCW.djhtm?c=1&etfid=JNPR.US&back=SPLG
CZR	Caesars Entertainment Inc	/etf/ea/ETZCW.djhtm?c=1&etfid=CZR.US&back=SPLG
RCL	Royal Caribbean Group	/etf/ea/ETZCW.djhtm?c=1&etfid=RCL.US&back=SPLG
LUMN	Lumen Technologies Inc.	/etf/ea/ETZCW.djhtm?c=1&etfid=LUMN.US&back=SPLG
BWA	BorgWarner Inc.	/etf/ea/ETZCW.djhtm?c=1&etfid=BWA.US&back=SPLG
BBWI	Bath & Body Works Inc.	/etf/ea/ETZCW.djhtm?c=1&etfid=BBWI.US&back=SPLG
GL	Globe Life Inc.	/etf/ea/ETZCW.djhtm?c=1&etfid=GL.US&back=SPLG
WHR	Whirlpool Corporation	/etf/ea/ETZCW.djhtm?c=1&etfid=WHR.US&back=SPLG
TPR	Tapestry Inc.	/etf/ea/ETZCW.djhtm?c=1&etfid=TPR.US&back=SPLG
AIZ	Assurant Inc.	/etf/ea/ETZCW.djhtm?c=1&etfid=AIZ.US&back=SPLG
PNW	Pinnacle West Capital Corporation	/etf/ea/ETZCW.djhtm?c=1&etfid=PNW.US&back=SPLG
RHI	Robert Half International Inc.	/etf/ea/ETZCW.djhtm?c=1&etfid=RHI.US&back=SPLG
ALLE	Allegion Public Limited Company	/etf/ea/ETZCW.djhtm?c=1&etfid=ALLE.US&back=SPLG
ZION	Zions Bancorporation N.A.	/etf/ea/ETZCW.djhtm?c=1&etfid=ZION.US&back=SPLG
AAL	American Airlines Group Inc.	/etf/ea/ETZCW.djhtm?c=1&etfid=AAL.US&back=SPLG
FBHS	Fortune Brands Home & Security Inc.	/etf/ea/ETZCW.djhtm?c=1&etfid=FBHS.US&back=SPLG
CDAY	Ceridian HCM Holding Inc.	/etf/ea/ETZCW.djhtm?c=1&etfid=CDAY.US&back=SPLG
SEE	Sealed Air Corporation	/etf/ea/ETZCW.djhtm?c=1&etfid=SEE.US&back=SPLG
ROL	Rollins Inc.	/etf/ea/ETZCW.djhtm?c=1&etfid=ROL.US&back=SPLG
AOS	A. O. Smith Corporation	/etf/ea/ETZCW.djhtm?c=1&etfid=AOS.US&back=SPLG
LNC	Lincoln National Corporation	/etf/ea/ETZCW.djhtm?c=1&etfid=LNC.US&back=SPLG
PNR	Pentair plc	/etf/ea/ETZCW.djhtm?c=1&etfid=PNR.US&back=SPLG
OGN	Organon & Co.	/etf/ea/ETZCW.djhtm?c=1&etfid=OGN.US&back=SPLG
BEN	Franklin Resources Inc.	/etf/ea/ETZCW.djhtm?c=1&etfid=BEN.US&back=SPLG
XRAY	DENTSPLY SIRONA Inc.	/etf/ea/ETZCW.djhtm?c=1&etfid=XRAY.US&back=SPLG
FRT	Federal Realty Investment Trust	/etf/ea/ETZCW.djhtm?c=1&etfid=FRT.US&back=SPLG
NWL	Newell Brands Inc	/etf/ea/ETZCW.djhtm?c=1&etfid=NWL.US&back=SPLG
NWSA	News Corporation Class A	/etf/ea/ETZCW.djhtm?c=1&etfid=NWSA.US&back=SPLG
UHS	Universal Health Services Inc. Class B	/etf/ea/ETZCW.djhtm?c=1&etfid=UHS.US&back=SPLG
WYNN	Wynn Resorts Limited	/etf/ea/ETZCW.djhtm?c=1&etfid=WYNN.US&back=SPLG
DXC	DXC Technology Co.	/etf/ea/ETZCW.djhtm?c=1&etfid=DXC.US&back=SPLG
MHK	Mohawk Industries Inc.	/etf/ea/ETZCW.djhtm?c=1&etfid=MHK.US&back=SPLG
IVZ	Invesco Ltd.	/etf/ea/ETZCW.djhtm?c=1&etfid=IVZ.US&back=SPLG
NCLH	Norwegian Cruise Line Holdings Ltd.	/etf/ea/ETZCW.djhtm?c=1&etfid=NCLH.US&back=SPLG
ALK	Alaska Air Group Inc.	/etf/ea/ETZCW.djhtm?c=1&etfid=ALK.US&back=SPLG
	U.S. Dollar	
PENN	PENN Entertainment Inc.	/etf/ea/ETZCW.djhtm?c=1&etfid=PENN.US&back=SPLG
DVA	DaVita Inc.	/etf/ea/ETZCW.djhtm?c=1&etfid=DVA.US&back=SPLG
FOX	Fox Corporation Class B	/etf/ea/ETZCW.djhtm?c=1&etfid=FOX.US&back=SPLG
DISH	DISH Network Corporation Class A	/etf/ea/ETZCW.djhtm?c=1&etfid=DISH.US&back=SPLG
RL	Ralph Lauren Corporation Class A	/etf/ea/ETZCW.djhtm?c=1&etfid=RL.US&back=SPLG
VNO	Vornado Realty Trust	/etf/ea/ETZCW.djhtm?c=1&etfid=VNO.US&back=SPLG
PVH	PVH Corp.	/etf/ea/ETZCW.djhtm?c=1&etfid=PVH.US&back=SPLG
