SSPY
WMT	WALMART INC	/etf/ea/ETZCW.djhtm?c=1&etfid=WMT.US&back=SSPY
XOM	EXXON MOBIL CORP	/etf/ea/ETZCW.djhtm?c=1&etfid=XOM.US&back=SSPY
CVX	CHEVRON CORP	/etf/ea/ETZCW.djhtm?c=1&etfid=CVX.US&back=SSPY
COST	COSTCO WHOLESALE CORP	/etf/ea/ETZCW.djhtm?c=1&etfid=COST.US&back=SSPY
KR	KROGER CO	/etf/ea/ETZCW.djhtm?c=1&etfid=KR.US&back=SSPY
SYY	SYSCO CORP	/etf/ea/ETZCW.djhtm?c=1&etfid=SYY.US&back=SSPY
CVS	CVS HEALTH CORP	/etf/ea/ETZCW.djhtm?c=1&etfid=CVS.US&back=SSPY
MSFT	MICROSOFT CORP	/etf/ea/ETZCW.djhtm?c=1&etfid=MSFT.US&back=SSPY
WBA	WALGREENS BOOTS ALLIANCE INC	/etf/ea/ETZCW.djhtm?c=1&etfid=WBA.US&back=SSPY
MPC	MARATHON PETROLEUM CORP	/etf/ea/ETZCW.djhtm?c=1&etfid=MPC.US&back=SSPY
DRI	DARDEN RESTAURANTS INC	/etf/ea/ETZCW.djhtm?c=1&etfid=DRI.US&back=SSPY
HRL	HORMEL FOODS CORP	/etf/ea/ETZCW.djhtm?c=1&etfid=HRL.US&back=SSPY
SBUX	STARBUCKS CORP	/etf/ea/ETZCW.djhtm?c=1&etfid=SBUX.US&back=SSPY
VLO	VALERO ENERGY CORP	/etf/ea/ETZCW.djhtm?c=1&etfid=VLO.US&back=SSPY
TJX	TJX COMPANIES INC	/etf/ea/ETZCW.djhtm?c=1&etfid=TJX.US&back=SSPY
BRK.B	BERKSHIRE HATHAWAY INC CL B	/etf/ea/ETZCW.djhtm?c=1&etfid=BRK.B.US&back=SSPY
YUM	YUM  BRANDS INC	/etf/ea/ETZCW.djhtm?c=1&etfid=YUM.US&back=SSPY
PSX	PHILLIPS 66	/etf/ea/ETZCW.djhtm?c=1&etfid=PSX.US&back=SSPY
PG	PROCTER + GAMBLE CO/THE	/etf/ea/ETZCW.djhtm?c=1&etfid=PG.US&back=SSPY
ROST	ROSS STORES INC	/etf/ea/ETZCW.djhtm?c=1&etfid=ROST.US&back=SSPY
MSI	MOTOROLA SOLUTIONS INC	/etf/ea/ETZCW.djhtm?c=1&etfid=MSI.US&back=SSPY
CL	COLGATE PALMOLIVE CO	/etf/ea/ETZCW.djhtm?c=1&etfid=CL.US&back=SSPY
CHD	CHURCH + DWIGHT CO INC	/etf/ea/ETZCW.djhtm?c=1&etfid=CHD.US&back=SSPY
AAPL	APPLE INC	/etf/ea/ETZCW.djhtm?c=1&etfid=AAPL.US&back=SSPY
ADM	ARCHER DANIELS MIDLAND CO	/etf/ea/ETZCW.djhtm?c=1&etfid=ADM.US&back=SSPY
HPQ	HP INC	/etf/ea/ETZCW.djhtm?c=1&etfid=HPQ.US&back=SSPY
L	LOEWS CORP	/etf/ea/ETZCW.djhtm?c=1&etfid=L.US&back=SSPY
KMB	KIMBERLY CLARK CORP	/etf/ea/ETZCW.djhtm?c=1&etfid=KMB.US&back=SSPY
GRMN	GARMIN LTD	/etf/ea/ETZCW.djhtm?c=1&etfid=GRMN.US&back=SSPY
MCD	MCDONALD S CORP	/etf/ea/ETZCW.djhtm?c=1&etfid=MCD.US&back=SSPY
RL	RALPH LAUREN CORP	/etf/ea/ETZCW.djhtm?c=1&etfid=RL.US&back=SSPY
TSN	TYSON FOODS INC CL A	/etf/ea/ETZCW.djhtm?c=1&etfid=TSN.US&back=SSPY
CLX	CLOROX COMPANY	/etf/ea/ETZCW.djhtm?c=1&etfid=CLX.US&back=SSPY
CMG	CHIPOTLE MEXICAN GRILL INC	/etf/ea/ETZCW.djhtm?c=1&etfid=CMG.US&back=SSPY
DPZ	DOMINO S PIZZA INC	/etf/ea/ETZCW.djhtm?c=1&etfid=DPZ.US&back=SSPY
EL	ESTEE LAUDER COMPANIES CL A	/etf/ea/ETZCW.djhtm?c=1&etfid=EL.US&back=SSPY
BBWI	BATH + BODY WORKS INC	/etf/ea/ETZCW.djhtm?c=1&etfid=BBWI.US&back=SSPY
CEG	CONSTELLATION ENERGY	/etf/ea/ETZCW.djhtm?c=1&etfid=CEG.US&back=SSPY
TWTR	TWITTER INC	/etf/ea/ETZCW.djhtm?c=1&etfid=TWTR.US&back=SSPY
MO	ALTRIA GROUP INC	/etf/ea/ETZCW.djhtm?c=1&etfid=MO.US&back=SSPY
NRG	NRG ENERGY INC	/etf/ea/ETZCW.djhtm?c=1&etfid=NRG.US&back=SSPY
NEM	NEWMONT CORP	/etf/ea/ETZCW.djhtm?c=1&etfid=NEM.US&back=SSPY
PM	PHILIP MORRIS INTERNATIONAL	/etf/ea/ETZCW.djhtm?c=1&etfid=PM.US&back=SSPY
PWR	QUANTA SERVICES INC	/etf/ea/ETZCW.djhtm?c=1&etfid=PWR.US&back=SSPY
J	JACOBS SOLUTIONS INC	/etf/ea/ETZCW.djhtm?c=1&etfid=J.US&back=SSPY
CDNS	CADENCE DESIGN SYS INC	/etf/ea/ETZCW.djhtm?c=1&etfid=CDNS.US&back=SSPY
ATVI	ACTIVISION BLIZZARD INC	/etf/ea/ETZCW.djhtm?c=1&etfid=ATVI.US&back=SSPY
APTV	APTIV PLC	/etf/ea/ETZCW.djhtm?c=1&etfid=APTV.US&back=SSPY
AES	AES CORP	/etf/ea/ETZCW.djhtm?c=1&etfid=AES.US&back=SSPY
BWA	BORGWARNER INC	/etf/ea/ETZCW.djhtm?c=1&etfid=BWA.US&back=SSPY
KMI	KINDER MORGAN INC	/etf/ea/ETZCW.djhtm?c=1&etfid=KMI.US&back=SSPY
EXC	EXELON CORP	/etf/ea/ETZCW.djhtm?c=1&etfid=EXC.US&back=SSPY
FTNT	FORTINET INC	/etf/ea/ETZCW.djhtm?c=1&etfid=FTNT.US&back=SSPY
SLB	SCHLUMBERGER LTD	/etf/ea/ETZCW.djhtm?c=1&etfid=SLB.US&back=SSPY
VRSN	VERISIGN INC	/etf/ea/ETZCW.djhtm?c=1&etfid=VRSN.US&back=SSPY
SNPS	SYNOPSYS INC	/etf/ea/ETZCW.djhtm?c=1&etfid=SNPS.US&back=SSPY
NLOK	NORTONLIFELOCK INC	/etf/ea/ETZCW.djhtm?c=1&etfid=NLOK.US&back=SSPY
EA	ELECTRONIC ARTS INC	/etf/ea/ETZCW.djhtm?c=1&etfid=EA.US&back=SSPY
DFS	DISCOVER FINANCIAL SERVICES	/etf/ea/ETZCW.djhtm?c=1&etfid=DFS.US&back=SSPY
CRM	SALESFORCE INC	/etf/ea/ETZCW.djhtm?c=1&etfid=CRM.US&back=SSPY
BIIB	BIOGEN INC	/etf/ea/ETZCW.djhtm?c=1&etfid=BIIB.US&back=SSPY
ATO	ATMOS ENERGY CORP	/etf/ea/ETZCW.djhtm?c=1&etfid=ATO.US&back=SSPY
AKAM	AKAMAI TECHNOLOGIES INC	/etf/ea/ETZCW.djhtm?c=1&etfid=AKAM.US&back=SSPY
COF	CAPITAL ONE FINANCIAL CORP	/etf/ea/ETZCW.djhtm?c=1&etfid=COF.US&back=SSPY
EQIX	EQUINIX INC	/etf/ea/ETZCW.djhtm?c=1&etfid=EQIX.US&back=SSPY
WMB	WILLIAMS COS INC	/etf/ea/ETZCW.djhtm?c=1&etfid=WMB.US&back=SSPY
UHS	UNIVERSAL HEALTH SERVICES B	/etf/ea/ETZCW.djhtm?c=1&etfid=UHS.US&back=SSPY
TTWO	TAKE TWO INTERACTIVE SOFTWRE	/etf/ea/ETZCW.djhtm?c=1&etfid=TTWO.US&back=SSPY
SYF	SYNCHRONY FINANCIAL	/etf/ea/ETZCW.djhtm?c=1&etfid=SYF.US&back=SSPY
FCX	FREEPORT MCMORAN INC	/etf/ea/ETZCW.djhtm?c=1&etfid=FCX.US&back=SSPY
HAL	HALLIBURTON CO	/etf/ea/ETZCW.djhtm?c=1&etfid=HAL.US&back=SSPY
HCA	HCA HEALTHCARE INC	/etf/ea/ETZCW.djhtm?c=1&etfid=HCA.US&back=SSPY
CMCSA	COMCAST CORP CLASS A	/etf/ea/ETZCW.djhtm?c=1&etfid=CMCSA.US&back=SSPY
AWK	AMERICAN WATER WORKS CO INC	/etf/ea/ETZCW.djhtm?c=1&etfid=AWK.US&back=SSPY
BKR	BAKER HUGHES CO	/etf/ea/ETZCW.djhtm?c=1&etfid=BKR.US&back=SSPY
HUM	HUMANA INC	/etf/ea/ETZCW.djhtm?c=1&etfid=HUM.US&back=SSPY
NI	NISOURCE INC	/etf/ea/ETZCW.djhtm?c=1&etfid=NI.US&back=SSPY
OKE	ONEOK INC	/etf/ea/ETZCW.djhtm?c=1&etfid=OKE.US&back=SSPY
ORCL	ORACLE CORP	/etf/ea/ETZCW.djhtm?c=1&etfid=ORCL.US&back=SSPY
META	META PLATFORMS INC CLASS A	/etf/ea/ETZCW.djhtm?c=1&etfid=META.US&back=SSPY
TPR	TAPESTRY INC	/etf/ea/ETZCW.djhtm?c=1&etfid=TPR.US&back=SSPY
UNH	UNITEDHEALTH GROUP INC	/etf/ea/ETZCW.djhtm?c=1&etfid=UNH.US&back=SSPY
DLR	DIGITAL REALTY TRUST INC	/etf/ea/ETZCW.djhtm?c=1&etfid=DLR.US&back=SSPY
MOH	MOLINA HEALTHCARE INC	/etf/ea/ETZCW.djhtm?c=1&etfid=MOH.US&back=SSPY
NVR	NVR INC	/etf/ea/ETZCW.djhtm?c=1&etfid=NVR.US&back=SSPY
MTCH	MATCH GROUP INC	/etf/ea/ETZCW.djhtm?c=1&etfid=MTCH.US&back=SSPY
NKE	NIKE INC  CL B	/etf/ea/ETZCW.djhtm?c=1&etfid=NKE.US&back=SSPY
NUE	NUCOR CORP	/etf/ea/ETZCW.djhtm?c=1&etfid=NUE.US&back=SSPY
CHTR	CHARTER COMMUNICATIONS INC A	/etf/ea/ETZCW.djhtm?c=1&etfid=CHTR.US&back=SSPY
LUMN	LUMEN TECHNOLOGIES INC	/etf/ea/ETZCW.djhtm?c=1&etfid=LUMN.US&back=SSPY
ELV	ELEVANCE HEALTH INC	/etf/ea/ETZCW.djhtm?c=1&etfid=ELV.US&back=SSPY
LLY	ELI LILLY + CO	/etf/ea/ETZCW.djhtm?c=1&etfid=LLY.US&back=SSPY
LEN	LENNAR CORP A	/etf/ea/ETZCW.djhtm?c=1&etfid=LEN.US&back=SSPY
BMY	BRISTOL MYERS SQUIBB CO	/etf/ea/ETZCW.djhtm?c=1&etfid=BMY.US&back=SSPY
MNST	MONSTER BEVERAGE CORP	/etf/ea/ETZCW.djhtm?c=1&etfid=MNST.US&back=SSPY
SCHW	SCHWAB (CHARLES) CORP	/etf/ea/ETZCW.djhtm?c=1&etfid=SCHW.US&back=SSPY
REGN	REGENERON PHARMACEUTICALS	/etf/ea/ETZCW.djhtm?c=1&etfid=REGN.US&back=SSPY
RJF	RAYMOND JAMES FINANCIAL INC	/etf/ea/ETZCW.djhtm?c=1&etfid=RJF.US&back=SSPY
STZ	CONSTELLATION BRANDS INC A	/etf/ea/ETZCW.djhtm?c=1&etfid=STZ.US&back=SSPY
PCG	PG&E CORP	/etf/ea/ETZCW.djhtm?c=1&etfid=PCG.US&back=SSPY
MRK	MERCK + CO. INC.	/etf/ea/ETZCW.djhtm?c=1&etfid=MRK.US&back=SSPY
ULTA	ULTA BEAUTY INC	/etf/ea/ETZCW.djhtm?c=1&etfid=ULTA.US&back=SSPY
TMUS	T MOBILE US INC	/etf/ea/ETZCW.djhtm?c=1&etfid=TMUS.US&back=SSPY
T	AT+T INC	/etf/ea/ETZCW.djhtm?c=1&etfid=T.US&back=SSPY
TAP	MOLSON COORS BEVERAGE CO   B	/etf/ea/ETZCW.djhtm?c=1&etfid=TAP.US&back=SSPY
VRTX	VERTEX PHARMACEUTICALS INC	/etf/ea/ETZCW.djhtm?c=1&etfid=VRTX.US&back=SSPY
VFC	VF CORP	/etf/ea/ETZCW.djhtm?c=1&etfid=VFC.US&back=SSPY
BF.B	BROWN FORMAN CORP CLASS B	/etf/ea/ETZCW.djhtm?c=1&etfid=BF.B.US&back=SSPY
CNC	CENTENE CORP	/etf/ea/ETZCW.djhtm?c=1&etfid=CNC.US&back=SSPY
DHI	DR HORTON INC	/etf/ea/ETZCW.djhtm?c=1&etfid=DHI.US&back=SSPY
KO	COCA COLA CO/THE	/etf/ea/ETZCW.djhtm?c=1&etfid=KO.US&back=SSPY
JNJ	JOHNSON + JOHNSON	/etf/ea/ETZCW.djhtm?c=1&etfid=JNJ.US&back=SSPY
KDP	KEURIG DR PEPPER INC	/etf/ea/ETZCW.djhtm?c=1&etfid=KDP.US&back=SSPY
LOW	LOWE S COS INC	/etf/ea/ETZCW.djhtm?c=1&etfid=LOW.US&back=SSPY
HD	HOME DEPOT INC	/etf/ea/ETZCW.djhtm?c=1&etfid=HD.US&back=SSPY
ENPH	ENPHASE ENERGY INC	/etf/ea/ETZCW.djhtm?c=1&etfid=ENPH.US&back=SSPY
ETN	EATON CORP PLC	/etf/ea/ETZCW.djhtm?c=1&etfid=ETN.US&back=SSPY
HIG	HARTFORD FINANCIAL SVCS GRP	/etf/ea/ETZCW.djhtm?c=1&etfid=HIG.US&back=SSPY
GILD	GILEAD SCIENCES INC	/etf/ea/ETZCW.djhtm?c=1&etfid=GILD.US&back=SSPY
GIS	GENERAL MILLS INC	/etf/ea/ETZCW.djhtm?c=1&etfid=GIS.US&back=SSPY
FE	FIRSTENERGY CORP	/etf/ea/ETZCW.djhtm?c=1&etfid=FE.US&back=SSPY
DVN	DEVON ENERGY CORP	/etf/ea/ETZCW.djhtm?c=1&etfid=DVN.US&back=SSPY
HPE	HEWLETT PACKARD ENTERPRISE	/etf/ea/ETZCW.djhtm?c=1&etfid=HPE.US&back=SSPY
INCY	INCYTE CORP	/etf/ea/ETZCW.djhtm?c=1&etfid=INCY.US&back=SSPY
	CITRIX SYSTEMS INC	
CTRA	COTERRA ENERGY INC	/etf/ea/ETZCW.djhtm?c=1&etfid=CTRA.US&back=SSPY
APH	AMPHENOL CORP CL A	/etf/ea/ETZCW.djhtm?c=1&etfid=APH.US&back=SSPY
ABBV	ABBVIE INC	/etf/ea/ETZCW.djhtm?c=1&etfid=ABBV.US&back=SSPY
VZ	VERIZON COMMUNICATIONS INC	/etf/ea/ETZCW.djhtm?c=1&etfid=VZ.US&back=SSPY
TSLA	TESLA INC	/etf/ea/ETZCW.djhtm?c=1&etfid=TSLA.US&back=SSPY
MS	MORGAN STANLEY	/etf/ea/ETZCW.djhtm?c=1&etfid=MS.US&back=SSPY
NEE	NEXTERA ENERGY INC	/etf/ea/ETZCW.djhtm?c=1&etfid=NEE.US&back=SSPY
NFLX	NETFLIX INC	/etf/ea/ETZCW.djhtm?c=1&etfid=NFLX.US&back=SSPY
PHM	PULTEGROUP INC	/etf/ea/ETZCW.djhtm?c=1&etfid=PHM.US&back=SSPY
PFE	PFIZER INC	/etf/ea/ETZCW.djhtm?c=1&etfid=PFE.US&back=SSPY
SJM	JM SMUCKER CO/THE	/etf/ea/ETZCW.djhtm?c=1&etfid=SJM.US&back=SSPY
NTAP	NETAPP INC	/etf/ea/ETZCW.djhtm?c=1&etfid=NTAP.US&back=SSPY
TEL	TE CONNECTIVITY LTD	/etf/ea/ETZCW.djhtm?c=1&etfid=TEL.US&back=SSPY
ZTS	ZOETIS INC	/etf/ea/ETZCW.djhtm?c=1&etfid=ZTS.US&back=SSPY
AIG	AMERICAN INTERNATIONAL GROUP	/etf/ea/ETZCW.djhtm?c=1&etfid=AIG.US&back=SSPY
AMGN	AMGEN INC	/etf/ea/ETZCW.djhtm?c=1&etfid=AMGN.US&back=SSPY
CPB	CAMPBELL SOUP CO	/etf/ea/ETZCW.djhtm?c=1&etfid=CPB.US&back=SSPY
DTE	DTE ENERGY COMPANY	/etf/ea/ETZCW.djhtm?c=1&etfid=DTE.US&back=SSPY
CNP	CENTERPOINT ENERGY INC	/etf/ea/ETZCW.djhtm?c=1&etfid=CNP.US&back=SSPY
LW	LAMB WESTON HOLDINGS INC	/etf/ea/ETZCW.djhtm?c=1&etfid=LW.US&back=SSPY
ED	CONSOLIDATED EDISON INC	/etf/ea/ETZCW.djhtm?c=1&etfid=ED.US&back=SSPY
ETR	ENTERGY CORP	/etf/ea/ETZCW.djhtm?c=1&etfid=ETR.US&back=SSPY
GLW	CORNING INC	/etf/ea/ETZCW.djhtm?c=1&etfid=GLW.US&back=SSPY
GS	GOLDMAN SACHS GROUP INC	/etf/ea/ETZCW.djhtm?c=1&etfid=GS.US&back=SSPY
EIX	EDISON INTERNATIONAL	/etf/ea/ETZCW.djhtm?c=1&etfid=EIX.US&back=SSPY
CAG	CONAGRA BRANDS INC	/etf/ea/ETZCW.djhtm?c=1&etfid=CAG.US&back=SSPY
D	DOMINION ENERGY INC	/etf/ea/ETZCW.djhtm?c=1&etfid=D.US&back=SSPY
CPRT	COPART INC	/etf/ea/ETZCW.djhtm?c=1&etfid=CPRT.US&back=SSPY
AEP	AMERICAN ELECTRIC POWER	/etf/ea/ETZCW.djhtm?c=1&etfid=AEP.US&back=SSPY
ADP	AUTOMATIC DATA PROCESSING	/etf/ea/ETZCW.djhtm?c=1&etfid=ADP.US&back=SSPY
ADI	ANALOG DEVICES INC	/etf/ea/ETZCW.djhtm?c=1&etfid=ADI.US&back=SSPY
BBY	BEST BUY CO INC	/etf/ea/ETZCW.djhtm?c=1&etfid=BBY.US&back=SSPY
TXN	TEXAS INSTRUMENTS INC	/etf/ea/ETZCW.djhtm?c=1&etfid=TXN.US&back=SSPY
TYL	TYLER TECHNOLOGIES INC	/etf/ea/ETZCW.djhtm?c=1&etfid=TYL.US&back=SSPY
VTRS	VIATRIS INC	/etf/ea/ETZCW.djhtm?c=1&etfid=VTRS.US&back=SSPY
PEG	PUBLIC SERVICE ENTERPRISE GP	/etf/ea/ETZCW.djhtm?c=1&etfid=PEG.US&back=SSPY
PAYC	PAYCOM SOFTWARE INC	/etf/ea/ETZCW.djhtm?c=1&etfid=PAYC.US&back=SSPY
PAYX	PAYCHEX INC	/etf/ea/ETZCW.djhtm?c=1&etfid=PAYX.US&back=SSPY
STX	SEAGATE TECHNOLOGY HOLDINGS	/etf/ea/ETZCW.djhtm?c=1&etfid=STX.US&back=SSPY
NXPI	NXP SEMICONDUCTORS NV	/etf/ea/ETZCW.djhtm?c=1&etfid=NXPI.US&back=SSPY
ON	ON SEMICONDUCTOR	/etf/ea/ETZCW.djhtm?c=1&etfid=ON.US&back=SSPY
MRNA	MODERNA INC	/etf/ea/ETZCW.djhtm?c=1&etfid=MRNA.US&back=SSPY
MKC	MCCORMICK + CO NON VTG SHRS	/etf/ea/ETZCW.djhtm?c=1&etfid=MKC.US&back=SSPY
WRB	WR BERKLEY CORP	/etf/ea/ETZCW.djhtm?c=1&etfid=WRB.US&back=SSPY
CDAY	CERIDIAN HCM HOLDING INC	/etf/ea/ETZCW.djhtm?c=1&etfid=CDAY.US&back=SSPY
GM	GENERAL MOTORS CO	/etf/ea/ETZCW.djhtm?c=1&etfid=GM.US&back=SSPY
KHC	KRAFT HEINZ CO/THE	/etf/ea/ETZCW.djhtm?c=1&etfid=KHC.US&back=SSPY
INTU	INTUIT INC	/etf/ea/ETZCW.djhtm?c=1&etfid=INTU.US&back=SSPY
KEYS	KEYSIGHT TECHNOLOGIES IN	/etf/ea/ETZCW.djhtm?c=1&etfid=KEYS.US&back=SSPY
EXPE	EXPEDIA GROUP INC	/etf/ea/ETZCW.djhtm?c=1&etfid=EXPE.US&back=SSPY
CB	CHUBB LTD	/etf/ea/ETZCW.djhtm?c=1&etfid=CB.US&back=SSPY
CAH	CARDINAL HEALTH INC	/etf/ea/ETZCW.djhtm?c=1&etfid=CAH.US&back=SSPY
CI	CIGNA CORP	/etf/ea/ETZCW.djhtm?c=1&etfid=CI.US&back=SSPY
AVGO	BROADCOM INC	/etf/ea/ETZCW.djhtm?c=1&etfid=AVGO.US&back=SSPY
ABC	AMERISOURCEBERGEN CORP	/etf/ea/ETZCW.djhtm?c=1&etfid=ABC.US&back=SSPY
WDC	WESTERN DIGITAL CORP	/etf/ea/ETZCW.djhtm?c=1&etfid=WDC.US&back=SSPY
TRV	TRAVELERS COS INC/THE	/etf/ea/ETZCW.djhtm?c=1&etfid=TRV.US&back=SSPY
MCK	MCKESSON CORP	/etf/ea/ETZCW.djhtm?c=1&etfid=MCK.US&back=SSPY
OGN	ORGANON + CO	/etf/ea/ETZCW.djhtm?c=1&etfid=OGN.US&back=SSPY
SWKS	SKYWORKS SOLUTIONS INC	/etf/ea/ETZCW.djhtm?c=1&etfid=SWKS.US&back=SSPY
SEDG	SOLAREDGE TECHNOLOGIES INC	/etf/ea/ETZCW.djhtm?c=1&etfid=SEDG.US&back=SSPY
QCOM	QUALCOMM INC	/etf/ea/ETZCW.djhtm?c=1&etfid=QCOM.US&back=SSPY
QRVO	QORVO INC	/etf/ea/ETZCW.djhtm?c=1&etfid=QRVO.US&back=SSPY
RE	EVEREST RE GROUP LTD	/etf/ea/ETZCW.djhtm?c=1&etfid=RE.US&back=SSPY
PEP	PEPSICO INC	/etf/ea/ETZCW.djhtm?c=1&etfid=PEP.US&back=SSPY
ROL	ROLLINS INC	/etf/ea/ETZCW.djhtm?c=1&etfid=ROL.US&back=SSPY
NOW	SERVICENOW INC	/etf/ea/ETZCW.djhtm?c=1&etfid=NOW.US&back=SSPY
MPWR	MONOLITHIC POWER SYSTEMS INC	/etf/ea/ETZCW.djhtm?c=1&etfid=MPWR.US&back=SSPY
WBD	WARNER BROS DISCOVERY INC	/etf/ea/ETZCW.djhtm?c=1&etfid=WBD.US&back=SSPY
ANET	ARISTA NETWORKS INC	/etf/ea/ETZCW.djhtm?c=1&etfid=ANET.US&back=SSPY
BKNG	BOOKING HOLDINGS INC	/etf/ea/ETZCW.djhtm?c=1&etfid=BKNG.US&back=SSPY
CINF	CINCINNATI FINANCIAL CORP	/etf/ea/ETZCW.djhtm?c=1&etfid=CINF.US&back=SSPY
CSCO	CISCO SYSTEMS INC	/etf/ea/ETZCW.djhtm?c=1&etfid=CSCO.US&back=SSPY
CTLT	CATALENT INC	/etf/ea/ETZCW.djhtm?c=1&etfid=CTLT.US&back=SSPY
DISH	DISH NETWORK CORP A	/etf/ea/ETZCW.djhtm?c=1&etfid=DISH.US&back=SSPY
F	FORD MOTOR CO	/etf/ea/ETZCW.djhtm?c=1&etfid=F.US&back=SSPY
FFIV	F5 INC	/etf/ea/ETZCW.djhtm?c=1&etfid=FFIV.US&back=SSPY
K	KELLOGG CO	/etf/ea/ETZCW.djhtm?c=1&etfid=K.US&back=SSPY
JNPR	JUNIPER NETWORKS INC	/etf/ea/ETZCW.djhtm?c=1&etfid=JNPR.US&back=SSPY
HSY	HERSHEY CO/THE	/etf/ea/ETZCW.djhtm?c=1&etfid=HSY.US&back=SSPY
HSIC	HENRY SCHEIN INC	/etf/ea/ETZCW.djhtm?c=1&etfid=HSIC.US&back=SSPY
IEX	IDEX CORP	/etf/ea/ETZCW.djhtm?c=1&etfid=IEX.US&back=SSPY
FRC	FIRST REPUBLIC BANK/CA	/etf/ea/ETZCW.djhtm?c=1&etfid=FRC.US&back=SSPY
CTAS	CINTAS CORP	/etf/ea/ETZCW.djhtm?c=1&etfid=CTAS.US&back=SSPY
CMA	COMERICA INC	/etf/ea/ETZCW.djhtm?c=1&etfid=CMA.US&back=SSPY
WM	WASTE MANAGEMENT INC	/etf/ea/ETZCW.djhtm?c=1&etfid=WM.US&back=SSPY
XYL	XYLEM INC	/etf/ea/ETZCW.djhtm?c=1&etfid=XYL.US&back=SSPY
ZION	ZIONS BANCORP NA	/etf/ea/ETZCW.djhtm?c=1&etfid=ZION.US&back=SSPY
MDLZ	MONDELEZ INTERNATIONAL INC A	/etf/ea/ETZCW.djhtm?c=1&etfid=MDLZ.US&back=SSPY
RSG	REPUBLIC SERVICES INC	/etf/ea/ETZCW.djhtm?c=1&etfid=RSG.US&back=SSPY
SNA	SNAP ON INC	/etf/ea/ETZCW.djhtm?c=1&etfid=SNA.US&back=SSPY
SBNY	SIGNATURE BANK	/etf/ea/ETZCW.djhtm?c=1&etfid=SBNY.US&back=SSPY
SIVB	SVB FINANCIAL GROUP	/etf/ea/ETZCW.djhtm?c=1&etfid=SIVB.US&back=SSPY
SWK	STANLEY BLACK + DECKER INC	/etf/ea/ETZCW.djhtm?c=1&etfid=SWK.US&back=SSPY
RHI	ROBERT HALF INTL INC	/etf/ea/ETZCW.djhtm?c=1&etfid=RHI.US&back=SSPY
PCAR	PACCAR INC	/etf/ea/ETZCW.djhtm?c=1&etfid=PCAR.US&back=SSPY
PNR	PENTAIR PLC	/etf/ea/ETZCW.djhtm?c=1&etfid=PNR.US&back=SSPY
PARA	PARAMOUNT GLOBAL CLASS B	/etf/ea/ETZCW.djhtm?c=1&etfid=PARA.US&back=SSPY
DLTR	DOLLAR TREE INC	/etf/ea/ETZCW.djhtm?c=1&etfid=DLTR.US&back=SSPY
DG	DOLLAR GENERAL CORP	/etf/ea/ETZCW.djhtm?c=1&etfid=DG.US&back=SSPY
DIS	WALT DISNEY CO/THE	/etf/ea/ETZCW.djhtm?c=1&etfid=DIS.US&back=SSPY
ALL	ALLSTATE CORP	/etf/ea/ETZCW.djhtm?c=1&etfid=ALL.US&back=SSPY
GL	GLOBE LIFE INC	/etf/ea/ETZCW.djhtm?c=1&etfid=GL.US&back=SSPY
IR	INGERSOLL RAND INC	/etf/ea/ETZCW.djhtm?c=1&etfid=IR.US&back=SSPY
HAS	HASBRO INC	/etf/ea/ETZCW.djhtm?c=1&etfid=HAS.US&back=SSPY
GD	GENERAL DYNAMICS CORP	/etf/ea/ETZCW.djhtm?c=1&etfid=GD.US&back=SSPY
AFL	AFLAC INC	/etf/ea/ETZCW.djhtm?c=1&etfid=AFL.US&back=SSPY
DE	DEERE + CO	/etf/ea/ETZCW.djhtm?c=1&etfid=DE.US&back=SSPY
DGX	QUEST DIAGNOSTICS INC	/etf/ea/ETZCW.djhtm?c=1&etfid=DGX.US&back=SSPY
DOV	DOVER CORP	/etf/ea/ETZCW.djhtm?c=1&etfid=DOV.US&back=SSPY
PFG	PRINCIPAL FINANCIAL GROUP	/etf/ea/ETZCW.djhtm?c=1&etfid=PFG.US&back=SSPY
PGR	PROGRESSIVE CORP	/etf/ea/ETZCW.djhtm?c=1&etfid=PGR.US&back=SSPY
RTX	RAYTHEON TECHNOLOGIES CORP	/etf/ea/ETZCW.djhtm?c=1&etfid=RTX.US&back=SSPY
MLM	MARTIN MARIETTA MATERIALS	/etf/ea/ETZCW.djhtm?c=1&etfid=MLM.US&back=SSPY
MET	METLIFE INC	/etf/ea/ETZCW.djhtm?c=1&etfid=MET.US&back=SSPY
MMM	3M CO W/D	/etf/ea/ETZCW.djhtm?c=1&etfid=MMM.US&back=SSPY
VMC	VULCAN MATERIALS CO	/etf/ea/ETZCW.djhtm?c=1&etfid=VMC.US&back=SSPY
TXT	TEXTRON INC	/etf/ea/ETZCW.djhtm?c=1&etfid=TXT.US&back=SSPY
TER	TERADYNE INC	/etf/ea/ETZCW.djhtm?c=1&etfid=TER.US&back=SSPY
TGT	TARGET CORP	/etf/ea/ETZCW.djhtm?c=1&etfid=TGT.US&back=SSPY
NWL	NEWELL BRANDS INC	/etf/ea/ETZCW.djhtm?c=1&etfid=NWL.US&back=SSPY
PRU	PRUDENTIAL FINANCIAL INC	/etf/ea/ETZCW.djhtm?c=1&etfid=PRU.US&back=SSPY
PTC	PTC INC	/etf/ea/ETZCW.djhtm?c=1&etfid=PTC.US&back=SSPY
CAT	CATERPILLAR INC	/etf/ea/ETZCW.djhtm?c=1&etfid=CAT.US&back=SSPY
AIZ	ASSURANT INC	/etf/ea/ETZCW.djhtm?c=1&etfid=AIZ.US&back=SSPY
AMAT	APPLIED MATERIALS INC	/etf/ea/ETZCW.djhtm?c=1&etfid=AMAT.US&back=SSPY
ACN	ACCENTURE PLC CL A	/etf/ea/ETZCW.djhtm?c=1&etfid=ACN.US&back=SSPY
ADSK	AUTODESK INC	/etf/ea/ETZCW.djhtm?c=1&etfid=ADSK.US&back=SSPY
ANSS	ANSYS INC	/etf/ea/ETZCW.djhtm?c=1&etfid=ANSS.US&back=SSPY
GOOG	ALPHABET INC CL C	/etf/ea/ETZCW.djhtm?c=1&etfid=GOOG.US&back=SSPY
GOOGL	ALPHABET INC CL A	/etf/ea/ETZCW.djhtm?c=1&etfid=GOOGL.US&back=SSPY
ITW	ILLINOIS TOOL WORKS	/etf/ea/ETZCW.djhtm?c=1&etfid=ITW.US&back=SSPY
HON	HONEYWELL INTERNATIONAL INC	/etf/ea/ETZCW.djhtm?c=1&etfid=HON.US&back=SSPY
KLAC	KLA CORP	/etf/ea/ETZCW.djhtm?c=1&etfid=KLAC.US&back=SSPY
LH	LABORATORY CRP OF AMER HLDGS	/etf/ea/ETZCW.djhtm?c=1&etfid=LH.US&back=SSPY
LNC	LINCOLN NATIONAL CORP	/etf/ea/ETZCW.djhtm?c=1&etfid=LNC.US&back=SSPY
LRCX	LAM RESEARCH CORP	/etf/ea/ETZCW.djhtm?c=1&etfid=LRCX.US&back=SSPY
GE	GENERAL ELECTRIC CO	/etf/ea/ETZCW.djhtm?c=1&etfid=GE.US&back=SSPY
ETSY	ETSY INC	/etf/ea/ETZCW.djhtm?c=1&etfid=ETSY.US&back=SSPY
MAS	MASCO CORP	/etf/ea/ETZCW.djhtm?c=1&etfid=MAS.US&back=SSPY
WY	WEYERHAEUSER CO	/etf/ea/ETZCW.djhtm?c=1&etfid=WY.US&back=SSPY
WHR	WHIRLPOOL CORP	/etf/ea/ETZCW.djhtm?c=1&etfid=WHR.US&back=SSPY
UAL	UNITED AIRLINES HOLDINGS INC	/etf/ea/ETZCW.djhtm?c=1&etfid=UAL.US&back=SSPY
ORLY	O REILLY AUTOMOTIVE INC	/etf/ea/ETZCW.djhtm?c=1&etfid=ORLY.US&back=SSPY
FBHS	FORTUNE BRANDS HOME + SECURI	/etf/ea/ETZCW.djhtm?c=1&etfid=FBHS.US&back=SSPY
AMZN	AMAZON.COM INC	/etf/ea/ETZCW.djhtm?c=1&etfid=AMZN.US&back=SSPY
AOS	SMITH (A.O.) CORP	/etf/ea/ETZCW.djhtm?c=1&etfid=AOS.US&back=SSPY
AZO	AUTOZONE INC	/etf/ea/ETZCW.djhtm?c=1&etfid=AZO.US&back=SSPY
BA	BOEING CO/THE	/etf/ea/ETZCW.djhtm?c=1&etfid=BA.US&back=SSPY
AAL	AMERICAN AIRLINES GROUP INC	/etf/ea/ETZCW.djhtm?c=1&etfid=AAL.US&back=SSPY
ALK	ALASKA AIR GROUP INC	/etf/ea/ETZCW.djhtm?c=1&etfid=ALK.US&back=SSPY
DAL	DELTA AIR LINES INC	/etf/ea/ETZCW.djhtm?c=1&etfid=DAL.US&back=SSPY
ADBE	ADOBE INC	/etf/ea/ETZCW.djhtm?c=1&etfid=ADBE.US&back=SSPY
EBAY	EBAY INC	/etf/ea/ETZCW.djhtm?c=1&etfid=EBAY.US&back=SSPY
HII	HUNTINGTON INGALLS INDUSTRIE	/etf/ea/ETZCW.djhtm?c=1&etfid=HII.US&back=SSPY
LUV	SOUTHWEST AIRLINES CO	/etf/ea/ETZCW.djhtm?c=1&etfid=LUV.US&back=SSPY
NOC	NORTHROP GRUMMAN CORP	/etf/ea/ETZCW.djhtm?c=1&etfid=NOC.US&back=SSPY
MCHP	MICROCHIP TECHNOLOGY INC	/etf/ea/ETZCW.djhtm?c=1&etfid=MCHP.US&back=SSPY
MHK	MOHAWK INDUSTRIES INC	/etf/ea/ETZCW.djhtm?c=1&etfid=MHK.US&back=SSPY
MU	MICRON TECHNOLOGY INC	/etf/ea/ETZCW.djhtm?c=1&etfid=MU.US&back=SSPY
RMD	RESMED INC	/etf/ea/ETZCW.djhtm?c=1&etfid=RMD.US&back=SSPY
TSCO	TRACTOR SUPPLY COMPANY	/etf/ea/ETZCW.djhtm?c=1&etfid=TSCO.US&back=SSPY
SYK	STRYKER CORP	/etf/ea/ETZCW.djhtm?c=1&etfid=SYK.US&back=SSPY
TMO	THERMO FISHER SCIENTIFIC INC	/etf/ea/ETZCW.djhtm?c=1&etfid=TMO.US&back=SSPY
WFC	WELLS FARGO + CO	/etf/ea/ETZCW.djhtm?c=1&etfid=WFC.US&back=SSPY
ZBH	ZIMMER BIOMET HOLDINGS INC	/etf/ea/ETZCW.djhtm?c=1&etfid=ZBH.US&back=SSPY
ZBRA	ZEBRA TECHNOLOGIES CORP CL A	/etf/ea/ETZCW.djhtm?c=1&etfid=ZBRA.US&back=SSPY
URI	UNITED RENTALS INC	/etf/ea/ETZCW.djhtm?c=1&etfid=URI.US&back=SSPY
WAT	WATERS CORP	/etf/ea/ETZCW.djhtm?c=1&etfid=WAT.US&back=SSPY
POOL	POOL CORP	/etf/ea/ETZCW.djhtm?c=1&etfid=POOL.US&back=SSPY
LKQ	LKQ CORP	/etf/ea/ETZCW.djhtm?c=1&etfid=LKQ.US&back=SSPY
NVDA	NVIDIA CORP	/etf/ea/ETZCW.djhtm?c=1&etfid=NVDA.US&back=SSPY
MTD	METTLER TOLEDO INTERNATIONAL	/etf/ea/ETZCW.djhtm?c=1&etfid=MTD.US&back=SSPY
NLSN	NIELSEN HOLDINGS PLC	/etf/ea/ETZCW.djhtm?c=1&etfid=NLSN.US&back=SSPY
LMT	LOCKHEED MARTIN CORP	/etf/ea/ETZCW.djhtm?c=1&etfid=LMT.US&back=SSPY
LHX	L3HARRIS TECHNOLOGIES INC	/etf/ea/ETZCW.djhtm?c=1&etfid=LHX.US&back=SSPY
JPM	JPMORGAN CHASE + CO	/etf/ea/ETZCW.djhtm?c=1&etfid=JPM.US&back=SSPY
ILMN	ILLUMINA INC	/etf/ea/ETZCW.djhtm?c=1&etfid=ILMN.US&back=SSPY
INTC	INTEL CORP	/etf/ea/ETZCW.djhtm?c=1&etfid=INTC.US&back=SSPY
GPC	GENUINE PARTS CO	/etf/ea/ETZCW.djhtm?c=1&etfid=GPC.US&back=SSPY
DXCM	DEXCOM INC	/etf/ea/ETZCW.djhtm?c=1&etfid=DXCM.US&back=SSPY
FAST	FASTENAL CO	/etf/ea/ETZCW.djhtm?c=1&etfid=FAST.US&back=SSPY
A	AGILENT TECHNOLOGIES INC	/etf/ea/ETZCW.djhtm?c=1&etfid=A.US&back=SSPY
AAP	ADVANCE AUTO PARTS INC	/etf/ea/ETZCW.djhtm?c=1&etfid=AAP.US&back=SSPY
BAC	BANK OF AMERICA CORP	/etf/ea/ETZCW.djhtm?c=1&etfid=BAC.US&back=SSPY
AME	AMETEK INC	/etf/ea/ETZCW.djhtm?c=1&etfid=AME.US&back=SSPY
CRL	CHARLES RIVER LABORATORIES	/etf/ea/ETZCW.djhtm?c=1&etfid=CRL.US&back=SSPY
CDW	CDW CORP/DE	/etf/ea/ETZCW.djhtm?c=1&etfid=CDW.US&back=SSPY
C	CITIGROUP INC	/etf/ea/ETZCW.djhtm?c=1&etfid=C.US&back=SSPY
COO	COOPER COS INC/THE	/etf/ea/ETZCW.djhtm?c=1&etfid=COO.US&back=SSPY
CPT	CAMDEN PROPERTY TRUST	/etf/ea/ETZCW.djhtm?c=1&etfid=CPT.US&back=SSPY
CTSH	COGNIZANT TECH SOLUTIONS A	/etf/ea/ETZCW.djhtm?c=1&etfid=CTSH.US&back=SSPY
ARE	ALEXANDRIA REAL ESTATE EQUIT	/etf/ea/ETZCW.djhtm?c=1&etfid=ARE.US&back=SSPY
AMD	ADVANCED MICRO DEVICES	/etf/ea/ETZCW.djhtm?c=1&etfid=AMD.US&back=SSPY
AMP	AMERIPRISE FINANCIAL INC	/etf/ea/ETZCW.djhtm?c=1&etfid=AMP.US&back=SSPY
ALGN	ALIGN TECHNOLOGY INC	/etf/ea/ETZCW.djhtm?c=1&etfid=ALGN.US&back=SSPY
ESS	ESSEX PROPERTY TRUST INC	/etf/ea/ETZCW.djhtm?c=1&etfid=ESS.US&back=SSPY
DXC	DXC TECHNOLOGY CO	/etf/ea/ETZCW.djhtm?c=1&etfid=DXC.US&back=SSPY
HLT	HILTON WORLDWIDE HOLDINGS IN	/etf/ea/ETZCW.djhtm?c=1&etfid=HLT.US&back=SSPY
GWW	WW GRAINGER INC	/etf/ea/ETZCW.djhtm?c=1&etfid=GWW.US&back=SSPY
IPG	INTERPUBLIC GROUP OF COS INC	/etf/ea/ETZCW.djhtm?c=1&etfid=IPG.US&back=SSPY
IQV	IQVIA HOLDINGS INC	/etf/ea/ETZCW.djhtm?c=1&etfid=IQV.US&back=SSPY
IT	GARTNER INC	/etf/ea/ETZCW.djhtm?c=1&etfid=IT.US&back=SSPY
IBM	INTL BUSINESS MACHINES CORP	/etf/ea/ETZCW.djhtm?c=1&etfid=IBM.US&back=SSPY
LDOS	LEIDOS HOLDINGS INC	/etf/ea/ETZCW.djhtm?c=1&etfid=LDOS.US&back=SSPY
MAA	MID AMERICA APARTMENT COMM	/etf/ea/ETZCW.djhtm?c=1&etfid=MAA.US&back=SSPY
OMC	OMNICOM GROUP	/etf/ea/ETZCW.djhtm?c=1&etfid=OMC.US&back=SSPY
TECH	BIO TECHNE CORP	/etf/ea/ETZCW.djhtm?c=1&etfid=TECH.US&back=SSPY
TROW	T ROWE PRICE GROUP INC	/etf/ea/ETZCW.djhtm?c=1&etfid=TROW.US&back=SSPY
UDR	UDR INC	/etf/ea/ETZCW.djhtm?c=1&etfid=UDR.US&back=SSPY
VNO	VORNADO REALTY TRUST	/etf/ea/ETZCW.djhtm?c=1&etfid=VNO.US&back=SSPY
NTRS	NORTHERN TRUST CORP	/etf/ea/ETZCW.djhtm?c=1&etfid=NTRS.US&back=SSPY
PSA	PUBLIC STORAGE	/etf/ea/ETZCW.djhtm?c=1&etfid=PSA.US&back=SSPY
STT	STATE STREET CORP	/etf/ea/ETZCW.djhtm?c=1&etfid=STT.US&back=SSPY
MAR	MARRIOTT INTERNATIONAL  CL A	/etf/ea/ETZCW.djhtm?c=1&etfid=MAR.US&back=SSPY
KMX	CARMAX INC	/etf/ea/ETZCW.djhtm?c=1&etfid=KMX.US&back=SSPY
HST	HOST HOTELS + RESORTS INC	/etf/ea/ETZCW.djhtm?c=1&etfid=HST.US&back=SSPY
INVH	INVITATION HOMES INC	/etf/ea/ETZCW.djhtm?c=1&etfid=INVH.US&back=SSPY
HOLX	HOLOGIC INC	/etf/ea/ETZCW.djhtm?c=1&etfid=HOLX.US&back=SSPY
FOX	FOX CORP   CLASS B	/etf/ea/ETZCW.djhtm?c=1&etfid=FOX.US&back=SSPY
EPAM	EPAM SYSTEMS INC	/etf/ea/ETZCW.djhtm?c=1&etfid=EPAM.US&back=SSPY
EQR	EQUITY RESIDENTIAL	/etf/ea/ETZCW.djhtm?c=1&etfid=EQR.US&back=SSPY
EXR	EXTRA SPACE STORAGE INC	/etf/ea/ETZCW.djhtm?c=1&etfid=EXR.US&back=SSPY
AVB	AVALONBAY COMMUNITIES INC	/etf/ea/ETZCW.djhtm?c=1&etfid=AVB.US&back=SSPY
BEN	FRANKLIN RESOURCES INC	/etf/ea/ETZCW.djhtm?c=1&etfid=BEN.US&back=SSPY
BK	BANK OF NEW YORK MELLON CORP	/etf/ea/ETZCW.djhtm?c=1&etfid=BK.US&back=SSPY
BR	BROADRIDGE FINANCIAL SOLUTIO	/etf/ea/ETZCW.djhtm?c=1&etfid=BR.US&back=SSPY
BLK	BLACKROCK INC	/etf/ea/ETZCW.djhtm?c=1&etfid=BLK.US&back=SSPY
BXP	BOSTON PROPERTIES INC	/etf/ea/ETZCW.djhtm?c=1&etfid=BXP.US&back=SSPY
DHR	DANAHER CORP	/etf/ea/ETZCW.djhtm?c=1&etfid=DHR.US&back=SSPY
FOXA	FOX CORP   CLASS A	/etf/ea/ETZCW.djhtm?c=1&etfid=FOXA.US&back=SSPY
IVZ	INVESCO LTD	/etf/ea/ETZCW.djhtm?c=1&etfid=IVZ.US&back=SSPY
IDXX	IDEXX LABORATORIES INC	/etf/ea/ETZCW.djhtm?c=1&etfid=IDXX.US&back=SSPY
PKI	PERKINELMER INC	/etf/ea/ETZCW.djhtm?c=1&etfid=PKI.US&back=SSPY
NWS	NEWS CORP   CLASS B	/etf/ea/ETZCW.djhtm?c=1&etfid=NWS.US&back=SSPY
NWSA	NEWS CORP   CLASS A	/etf/ea/ETZCW.djhtm?c=1&etfid=NWSA.US&back=SSPY
ODFL	OLD DOMINION FREIGHT LINE	/etf/ea/ETZCW.djhtm?c=1&etfid=ODFL.US&back=SSPY
SRE	SEMPRA ENERGY	/etf/ea/ETZCW.djhtm?c=1&etfid=SRE.US&back=SSPY
JBHT	HUNT (JB) TRANSPRT SVCS INC	/etf/ea/ETZCW.djhtm?c=1&etfid=JBHT.US&back=SSPY
FMC	FMC CORP	/etf/ea/ETZCW.djhtm?c=1&etfid=FMC.US&back=SSPY
DVA	DAVITA INC	/etf/ea/ETZCW.djhtm?c=1&etfid=DVA.US&back=SSPY
CTVA	CORTEVA INC	/etf/ea/ETZCW.djhtm?c=1&etfid=CTVA.US&back=SSPY
CF	CF INDUSTRIES HOLDINGS INC	/etf/ea/ETZCW.djhtm?c=1&etfid=CF.US&back=SSPY
BIO	BIO RAD LABORATORIES A	/etf/ea/ETZCW.djhtm?c=1&etfid=BIO.US&back=SSPY
AMCR	AMCOR PLC	/etf/ea/ETZCW.djhtm?c=1&etfid=AMCR.US&back=SSPY
ABMD	ABIOMED INC	/etf/ea/ETZCW.djhtm?c=1&etfid=ABMD.US&back=SSPY
AEE	AMEREN CORPORATION	/etf/ea/ETZCW.djhtm?c=1&etfid=AEE.US&back=SSPY
BALL	BALL CORP	/etf/ea/ETZCW.djhtm?c=1&etfid=BALL.US&back=SSPY
CHRW	C.H. ROBINSON WORLDWIDE INC	/etf/ea/ETZCW.djhtm?c=1&etfid=CHRW.US&back=SSPY
CMI	CUMMINS INC	/etf/ea/ETZCW.djhtm?c=1&etfid=CMI.US&back=SSPY
CMS	CMS ENERGY CORP	/etf/ea/ETZCW.djhtm?c=1&etfid=CMS.US&back=SSPY
CSX	CSX CORP	/etf/ea/ETZCW.djhtm?c=1&etfid=CSX.US&back=SSPY
DUK	DUKE ENERGY CORP	/etf/ea/ETZCW.djhtm?c=1&etfid=DUK.US&back=SSPY
EXPD	EXPEDITORS INTL WASH INC	/etf/ea/ETZCW.djhtm?c=1&etfid=EXPD.US&back=SSPY
ES	EVERSOURCE ENERGY	/etf/ea/ETZCW.djhtm?c=1&etfid=ES.US&back=SSPY
EVRG	EVERGY INC	/etf/ea/ETZCW.djhtm?c=1&etfid=EVRG.US&back=SSPY
ISRG	INTUITIVE SURGICAL INC	/etf/ea/ETZCW.djhtm?c=1&etfid=ISRG.US&back=SSPY
LYV	LIVE NATION ENTERTAINMENT IN	/etf/ea/ETZCW.djhtm?c=1&etfid=LYV.US&back=SSPY
LVS	LAS VEGAS SANDS CORP	/etf/ea/ETZCW.djhtm?c=1&etfid=LVS.US&back=SSPY
LNT	ALLIANT ENERGY CORP	/etf/ea/ETZCW.djhtm?c=1&etfid=LNT.US&back=SSPY
STE	STERIS PLC	/etf/ea/ETZCW.djhtm?c=1&etfid=STE.US&back=SSPY
SO	SOUTHERN CO/THE	/etf/ea/ETZCW.djhtm?c=1&etfid=SO.US&back=SSPY
SEE	SEALED AIR CORP	/etf/ea/ETZCW.djhtm?c=1&etfid=SEE.US&back=SSPY
PEAK	HEALTHPEAK PROPERTIES INC	/etf/ea/ETZCW.djhtm?c=1&etfid=PEAK.US&back=SSPY
PPL	PPL CORP	/etf/ea/ETZCW.djhtm?c=1&etfid=PPL.US&back=SSPY
PNW	PINNACLE WEST CAPITAL	/etf/ea/ETZCW.djhtm?c=1&etfid=PNW.US&back=SSPY
RCL	ROYAL CARIBBEAN CRUISES LTD	/etf/ea/ETZCW.djhtm?c=1&etfid=RCL.US&back=SSPY
NSC	NORFOLK SOUTHERN CORP	/etf/ea/ETZCW.djhtm?c=1&etfid=NSC.US&back=SSPY
NCLH	NORWEGIAN CRUISE LINE HOLDIN	/etf/ea/ETZCW.djhtm?c=1&etfid=NCLH.US&back=SSPY
MOS	MOSAIC CO/THE	/etf/ea/ETZCW.djhtm?c=1&etfid=MOS.US&back=SSPY
VTR	VENTAS INC	/etf/ea/ETZCW.djhtm?c=1&etfid=VTR.US&back=SSPY
WYNN	WYNN RESORTS LTD	/etf/ea/ETZCW.djhtm?c=1&etfid=WYNN.US&back=SSPY
XEL	XCEL ENERGY INC	/etf/ea/ETZCW.djhtm?c=1&etfid=XEL.US&back=SSPY
WEC	WEC ENERGY GROUP INC	/etf/ea/ETZCW.djhtm?c=1&etfid=WEC.US&back=SSPY
WELL	WELLTOWER INC	/etf/ea/ETZCW.djhtm?c=1&etfid=WELL.US&back=SSPY
UNP	UNION PACIFIC CORP	/etf/ea/ETZCW.djhtm?c=1&etfid=UNP.US&back=SSPY
UPS	UNITED PARCEL SERVICE CL B	/etf/ea/ETZCW.djhtm?c=1&etfid=UPS.US&back=SSPY
TT	TRANE TECHNOLOGIES PLC	/etf/ea/ETZCW.djhtm?c=1&etfid=TT.US&back=SSPY
TDG	TRANSDIGM GROUP INC	/etf/ea/ETZCW.djhtm?c=1&etfid=TDG.US&back=SSPY
WAB	WABTEC CORP	/etf/ea/ETZCW.djhtm?c=1&etfid=WAB.US&back=SSPY
VICI	VICI PROPERTIES INC	/etf/ea/ETZCW.djhtm?c=1&etfid=VICI.US&back=SSPY
MDT	MEDTRONIC PLC	/etf/ea/ETZCW.djhtm?c=1&etfid=MDT.US&back=SSPY
MGM	MGM RESORTS INTERNATIONAL	/etf/ea/ETZCW.djhtm?c=1&etfid=MGM.US&back=SSPY
O	REALTY INCOME CORP	/etf/ea/ETZCW.djhtm?c=1&etfid=O.US&back=SSPY
OTIS	OTIS WORLDWIDE CORP	/etf/ea/ETZCW.djhtm?c=1&etfid=OTIS.US&back=SSPY
OXY	OCCIDENTAL PETROLEUM CORP	/etf/ea/ETZCW.djhtm?c=1&etfid=OXY.US&back=SSPY
REG	REGENCY CENTERS CORP	/etf/ea/ETZCW.djhtm?c=1&etfid=REG.US&back=SSPY
PXD	PIONEER NATURAL RESOURCES CO	/etf/ea/ETZCW.djhtm?c=1&etfid=PXD.US&back=SSPY
PPG	PPG INDUSTRIES INC	/etf/ea/ETZCW.djhtm?c=1&etfid=PPG.US&back=SSPY
PH	PARKER HANNIFIN CORP	/etf/ea/ETZCW.djhtm?c=1&etfid=PH.US&back=SSPY
SHW	SHERWIN WILLIAMS CO/THE	/etf/ea/ETZCW.djhtm?c=1&etfid=SHW.US&back=SSPY
SPG	SIMON PROPERTY GROUP INC	/etf/ea/ETZCW.djhtm?c=1&etfid=SPG.US&back=SSPY
LYB	LYONDELLBASELL INDU CL A	/etf/ea/ETZCW.djhtm?c=1&etfid=LYB.US&back=SSPY
KIM	KIMCO REALTY CORP	/etf/ea/ETZCW.djhtm?c=1&etfid=KIM.US&back=SSPY
JCI	JOHNSON CONTROLS INTERNATION	/etf/ea/ETZCW.djhtm?c=1&etfid=JCI.US&back=SSPY
HWM	HOWMET AEROSPACE INC	/etf/ea/ETZCW.djhtm?c=1&etfid=HWM.US&back=SSPY
HES	HESS CORP	/etf/ea/ETZCW.djhtm?c=1&etfid=HES.US&back=SSPY
FANG	DIAMONDBACK ENERGY INC	/etf/ea/ETZCW.djhtm?c=1&etfid=FANG.US&back=SSPY
EOG	EOG RESOURCES INC	/etf/ea/ETZCW.djhtm?c=1&etfid=EOG.US&back=SSPY
FDX	FEDEX CORP	/etf/ea/ETZCW.djhtm?c=1&etfid=FDX.US&back=SSPY
FRT	FEDERAL REALTY INVS TRUST	/etf/ea/ETZCW.djhtm?c=1&etfid=FRT.US&back=SSPY
HBAN	HUNTINGTON BANCSHARES INC	/etf/ea/ETZCW.djhtm?c=1&etfid=HBAN.US&back=SSPY
DOW	DOW INC	/etf/ea/ETZCW.djhtm?c=1&etfid=DOW.US&back=SSPY
COP	CONOCOPHILLIPS	/etf/ea/ETZCW.djhtm?c=1&etfid=COP.US&back=SSPY
BSX	BOSTON SCIENTIFIC CORP	/etf/ea/ETZCW.djhtm?c=1&etfid=BSX.US&back=SSPY
CARR	CARRIER GLOBAL CORP	/etf/ea/ETZCW.djhtm?c=1&etfid=CARR.US&back=SSPY
CCL	CARNIVAL CORP	/etf/ea/ETZCW.djhtm?c=1&etfid=CCL.US&back=SSPY
APA	APA CORP	/etf/ea/ETZCW.djhtm?c=1&etfid=APA.US&back=SSPY
ABT	ABBOTT LABORATORIES	/etf/ea/ETZCW.djhtm?c=1&etfid=ABT.US&back=SSPY
	NET OTHER ASSETS	
ALLE	ALLEGION PLC	/etf/ea/ETZCW.djhtm?c=1&etfid=ALLE.US&back=SSPY
AVY	AVERY DENNISON CORP	/etf/ea/ETZCW.djhtm?c=1&etfid=AVY.US&back=SSPY
CE	CELANESE CORP	/etf/ea/ETZCW.djhtm?c=1&etfid=CE.US&back=SSPY
CFG	CITIZENS FINANCIAL GROUP	/etf/ea/ETZCW.djhtm?c=1&etfid=CFG.US&back=SSPY
GNRC	GENERAC HOLDINGS INC	/etf/ea/ETZCW.djhtm?c=1&etfid=GNRC.US&back=SSPY
FISV	FISERV INC	/etf/ea/ETZCW.djhtm?c=1&etfid=FISV.US&back=SSPY
FITB	FIFTH THIRD BANCORP	/etf/ea/ETZCW.djhtm?c=1&etfid=FITB.US&back=SSPY
EW	EDWARDS LIFESCIENCES CORP	/etf/ea/ETZCW.djhtm?c=1&etfid=EW.US&back=SSPY
JKHY	JACK HENRY + ASSOCIATES INC	/etf/ea/ETZCW.djhtm?c=1&etfid=JKHY.US&back=SSPY
IP	INTERNATIONAL PAPER CO	/etf/ea/ETZCW.djhtm?c=1&etfid=IP.US&back=SSPY
KEY	KEYCORP	/etf/ea/ETZCW.djhtm?c=1&etfid=KEY.US&back=SSPY
SBAC	SBA COMMUNICATIONS CORP	/etf/ea/ETZCW.djhtm?c=1&etfid=SBAC.US&back=SSPY
RF	REGIONS FINANCIAL CORP	/etf/ea/ETZCW.djhtm?c=1&etfid=RF.US&back=SSPY
PKG	PACKAGING CORP OF AMERICA	/etf/ea/ETZCW.djhtm?c=1&etfid=PKG.US&back=SSPY
PNC	PNC FINANCIAL SERVICES GROUP	/etf/ea/ETZCW.djhtm?c=1&etfid=PNC.US&back=SSPY
PYPL	PAYPAL HOLDINGS INC	/etf/ea/ETZCW.djhtm?c=1&etfid=PYPL.US&back=SSPY
MRO	MARATHON OIL CORP	/etf/ea/ETZCW.djhtm?c=1&etfid=MRO.US&back=SSPY
MTB	M + T BANK CORP	/etf/ea/ETZCW.djhtm?c=1&etfid=MTB.US&back=SSPY
USB	US BANCORP	/etf/ea/ETZCW.djhtm?c=1&etfid=USB.US&back=SSPY
WRK	WESTROCK CO	/etf/ea/ETZCW.djhtm?c=1&etfid=WRK.US&back=SSPY
TFC	TRUIST FINANCIAL CORP	/etf/ea/ETZCW.djhtm?c=1&etfid=TFC.US&back=SSPY
TFX	TELEFLEX INC	/etf/ea/ETZCW.djhtm?c=1&etfid=TFX.US&back=SSPY
WST	WEST PHARMACEUTICAL SERVICES	/etf/ea/ETZCW.djhtm?c=1&etfid=WST.US&back=SSPY
XRAY	DENTSPLY SIRONA INC	/etf/ea/ETZCW.djhtm?c=1&etfid=XRAY.US&back=SSPY
V	VISA INC CLASS A SHARES	/etf/ea/ETZCW.djhtm?c=1&etfid=V.US&back=SSPY
VRSK	VERISK ANALYTICS INC	/etf/ea/ETZCW.djhtm?c=1&etfid=VRSK.US&back=SSPY
MSCI	MSCI INC	/etf/ea/ETZCW.djhtm?c=1&etfid=MSCI.US&back=SSPY
NDAQ	NASDAQ INC	/etf/ea/ETZCW.djhtm?c=1&etfid=NDAQ.US&back=SSPY
MCO	MOODY S CORP	/etf/ea/ETZCW.djhtm?c=1&etfid=MCO.US&back=SSPY
PLD	PROLOGIS INC	/etf/ea/ETZCW.djhtm?c=1&etfid=PLD.US&back=SSPY
SPGI	S+P GLOBAL INC	/etf/ea/ETZCW.djhtm?c=1&etfid=SPGI.US&back=SSPY
LIN	LINDE PLC	/etf/ea/ETZCW.djhtm?c=1&etfid=LIN.US&back=SSPY
IRM	IRON MOUNTAIN INC	/etf/ea/ETZCW.djhtm?c=1&etfid=IRM.US&back=SSPY
ICE	INTERCONTINENTAL EXCHANGE IN	/etf/ea/ETZCW.djhtm?c=1&etfid=ICE.US&back=SSPY
EQT	EQT Corporation	/etf/ea/ETZCW.djhtm?c=1&etfid=EQT.US&back=SSPY
ECL	ECOLAB INC	/etf/ea/ETZCW.djhtm?c=1&etfid=ECL.US&back=SSPY
EFX	EQUIFAX INC	/etf/ea/ETZCW.djhtm?c=1&etfid=EFX.US&back=SSPY
FIS	FIDELITY NATIONAL INFO SERV	/etf/ea/ETZCW.djhtm?c=1&etfid=FIS.US&back=SSPY
FDS	FACTSET RESEARCH SYSTEMS INC	/etf/ea/ETZCW.djhtm?c=1&etfid=FDS.US&back=SSPY
CME	CME GROUP INC	/etf/ea/ETZCW.djhtm?c=1&etfid=CME.US&back=SSPY
CCI	CROWN CASTLE INC	/etf/ea/ETZCW.djhtm?c=1&etfid=CCI.US&back=SSPY
CBOE	CBOE GLOBAL MARKETS INC	/etf/ea/ETZCW.djhtm?c=1&etfid=CBOE.US&back=SSPY
DD	DUPONT DE NEMOURS INC	/etf/ea/ETZCW.djhtm?c=1&etfid=DD.US&back=SSPY
CSGP	COSTAR GROUP INC	/etf/ea/ETZCW.djhtm?c=1&etfid=CSGP.US&back=SSPY
CZR	CAESARS ENTERTAINMENT INC	/etf/ea/ETZCW.djhtm?c=1&etfid=CZR.US&back=SSPY
APD	AIR PRODUCTS + CHEMICALS INC	/etf/ea/ETZCW.djhtm?c=1&etfid=APD.US&back=SSPY
BAX	BAXTER INTERNATIONAL INC	/etf/ea/ETZCW.djhtm?c=1&etfid=BAX.US&back=SSPY
BDX	BECTON DICKINSON AND CO	/etf/ea/ETZCW.djhtm?c=1&etfid=BDX.US&back=SSPY
AMT	AMERICAN TOWER CORP	/etf/ea/ETZCW.djhtm?c=1&etfid=AMT.US&back=SSPY
ALB	ALBEMARLE CORP	/etf/ea/ETZCW.djhtm?c=1&etfid=ALB.US&back=SSPY
	US DOLLAR	
AJG	ARTHUR J GALLAGHER + CO	/etf/ea/ETZCW.djhtm?c=1&etfid=AJG.US&back=SSPY
AON	AON PLC CLASS A	/etf/ea/ETZCW.djhtm?c=1&etfid=AON.US&back=SSPY
AXP	AMERICAN EXPRESS CO	/etf/ea/ETZCW.djhtm?c=1&etfid=AXP.US&back=SSPY
CBRE	CBRE GROUP INC   A	/etf/ea/ETZCW.djhtm?c=1&etfid=CBRE.US&back=SSPY
BRO	BROWN + BROWN INC	/etf/ea/ETZCW.djhtm?c=1&etfid=BRO.US&back=SSPY
FLT	FLEETCOR TECHNOLOGIES INC	/etf/ea/ETZCW.djhtm?c=1&etfid=FLT.US&back=SSPY
FTV	FORTIVE CORP	/etf/ea/ETZCW.djhtm?c=1&etfid=FTV.US&back=SSPY
GPN	GLOBAL PAYMENTS INC	/etf/ea/ETZCW.djhtm?c=1&etfid=GPN.US&back=SSPY
EMN	EASTMAN CHEMICAL CO	/etf/ea/ETZCW.djhtm?c=1&etfid=EMN.US&back=SSPY
EMR	EMERSON ELECTRIC CO	/etf/ea/ETZCW.djhtm?c=1&etfid=EMR.US&back=SSPY
IFF	INTL FLAVORS + FRAGRANCES	/etf/ea/ETZCW.djhtm?c=1&etfid=IFF.US&back=SSPY
MA	MASTERCARD INC   A	/etf/ea/ETZCW.djhtm?c=1&etfid=MA.US&back=SSPY
ROP	ROPER TECHNOLOGIES INC	/etf/ea/ETZCW.djhtm?c=1&etfid=ROP.US&back=SSPY
MMC	MARSH + MCLENNAN COS	/etf/ea/ETZCW.djhtm?c=1&etfid=MMC.US&back=SSPY
MKTX	MARKETAXESS HOLDINGS INC	/etf/ea/ETZCW.djhtm?c=1&etfid=MKTX.US&back=SSPY
NDSN	NORDSON CORP	/etf/ea/ETZCW.djhtm?c=1&etfid=NDSN.US&back=SSPY
WTW	WILLIS TOWERS WATSON PLC	/etf/ea/ETZCW.djhtm?c=1&etfid=WTW.US&back=SSPY
TDY	TELEDYNE TECHNOLOGIES INC	/etf/ea/ETZCW.djhtm?c=1&etfid=TDY.US&back=SSPY
TRMB	TRIMBLE INC	/etf/ea/ETZCW.djhtm?c=1&etfid=TRMB.US&back=SSPY
ROK	ROCKWELL AUTOMATION INC	/etf/ea/ETZCW.djhtm?c=1&etfid=ROK.US&back=SSPY
