VBK
ENTG	Entegris Inc.	/etf/ea/ETZCW.djhtm?c=1&etfid=ENTG.US&back=VBK
WOLF	Wolfspeed Inc.	/etf/ea/ETZCW.djhtm?c=1&etfid=WOLF.US&back=VBK
TECH	Bio-Techne Corp.	/etf/ea/ETZCW.djhtm?c=1&etfid=TECH.US&back=VBK
FWONK	Liberty Media Corp-Liberty Formula One	/etf/ea/ETZCW.djhtm?c=1&etfid=FWONK.US&back=VBK
DAR	Darling Ingredients Inc.	/etf/ea/ETZCW.djhtm?c=1&etfid=DAR.US&back=VBK
RGEN	Repligen Corp.	/etf/ea/ETZCW.djhtm?c=1&etfid=RGEN.US&back=VBK
PTC	PTC Inc.	/etf/ea/ETZCW.djhtm?c=1&etfid=PTC.US&back=VBK
NDSN	Nordson Corp.	/etf/ea/ETZCW.djhtm?c=1&etfid=NDSN.US&back=VBK
ELS	Equity LifeStyle Properties Inc.	/etf/ea/ETZCW.djhtm?c=1&etfid=ELS.US&back=VBK
FICO	Fair Isaac Corp.	/etf/ea/ETZCW.djhtm?c=1&etfid=FICO.US&back=VBK
TPL	Texas Pacific Land Corp.	/etf/ea/ETZCW.djhtm?c=1&etfid=TPL.US&back=VBK
GGG	Graco Inc.	/etf/ea/ETZCW.djhtm?c=1&etfid=GGG.US&back=VBK
CUBE	CubeSmart	/etf/ea/ETZCW.djhtm?c=1&etfid=CUBE.US&back=VBK
REXR	Rexford Industrial Realty Inc.	/etf/ea/ETZCW.djhtm?c=1&etfid=REXR.US&back=VBK
SWAV	Shockwave Medical Inc.	/etf/ea/ETZCW.djhtm?c=1&etfid=SWAV.US&back=VBK
AMH	American Homes 4 Rent Class A	/etf/ea/ETZCW.djhtm?c=1&etfid=AMH.US&back=VBK
NBIX	Neurocrine Biosciences Inc.	/etf/ea/ETZCW.djhtm?c=1&etfid=NBIX.US&back=VBK
WMS	Advanced Drainage Systems Inc.	/etf/ea/ETZCW.djhtm?c=1&etfid=WMS.US&back=VBK
PCTY	Paylocity Holding Corp.	/etf/ea/ETZCW.djhtm?c=1&etfid=PCTY.US&back=VBK
HR	Healthcare Trust of America Inc. Class A	/etf/ea/ETZCW.djhtm?c=1&etfid=HR.US&back=VBK
