VLUE
T	AT&T INC	/etf/ea/ETZCW.djhtm?c=1&etfid=T.US&back=VLUE
INTC	INTEL CORPORATION CORP	/etf/ea/ETZCW.djhtm?c=1&etfid=INTC.US&back=VLUE
CSCO	CISCO SYSTEMS INC	/etf/ea/ETZCW.djhtm?c=1&etfid=CSCO.US&back=VLUE
F	FORD MOTOR CO	/etf/ea/ETZCW.djhtm?c=1&etfid=F.US&back=VLUE
GM	GENERAL MOTORS	/etf/ea/ETZCW.djhtm?c=1&etfid=GM.US&back=VLUE
PFE	PFIZER INC	/etf/ea/ETZCW.djhtm?c=1&etfid=PFE.US&back=VLUE
MU	MICRON TECHNOLOGY INC	/etf/ea/ETZCW.djhtm?c=1&etfid=MU.US&back=VLUE
IBM	INTERNATIONAL BUSINESS MACHINES CO	/etf/ea/ETZCW.djhtm?c=1&etfid=IBM.US&back=VLUE
C	CITIGROUP INC	/etf/ea/ETZCW.djhtm?c=1&etfid=C.US&back=VLUE
ABBV	ABBVIE INC	/etf/ea/ETZCW.djhtm?c=1&etfid=ABBV.US&back=VLUE
RTX	RAYTHEON TECHNOLOGIES CORP	/etf/ea/ETZCW.djhtm?c=1&etfid=RTX.US&back=VLUE
WFC	WELLS FARGO	/etf/ea/ETZCW.djhtm?c=1&etfid=WFC.US&back=VLUE
CVS	CVS HEALTH CORP	/etf/ea/ETZCW.djhtm?c=1&etfid=CVS.US&back=VLUE
BMY	BRISTOL MYERS SQUIBB	/etf/ea/ETZCW.djhtm?c=1&etfid=BMY.US&back=VLUE
EOG	EOG RESOURCES INC	/etf/ea/ETZCW.djhtm?c=1&etfid=EOG.US&back=VLUE
GS	GOLDMAN SACHS GROUP INC	/etf/ea/ETZCW.djhtm?c=1&etfid=GS.US&back=VLUE
FIS	FIDELITY NATIONAL INFORMATION SERV	/etf/ea/ETZCW.djhtm?c=1&etfid=FIS.US&back=VLUE
MO	ALTRIA GROUP INC	/etf/ea/ETZCW.djhtm?c=1&etfid=MO.US&back=VLUE
AMAT	APPLIED MATERIAL INC	/etf/ea/ETZCW.djhtm?c=1&etfid=AMAT.US&back=VLUE
CI	CIGNA CORP	/etf/ea/ETZCW.djhtm?c=1&etfid=CI.US&back=VLUE
LEN	LENNAR A CORP	/etf/ea/ETZCW.djhtm?c=1&etfid=LEN.US&back=VLUE
FDX	FEDEX CORP	/etf/ea/ETZCW.djhtm?c=1&etfid=FDX.US&back=VLUE
WBD	WARNER BROS. DISCOVERY INC SERIES	/etf/ea/ETZCW.djhtm?c=1&etfid=WBD.US&back=VLUE
FISV	FISERV INC	/etf/ea/ETZCW.djhtm?c=1&etfid=FISV.US&back=VLUE
DHI	D R HORTON INC	/etf/ea/ETZCW.djhtm?c=1&etfid=DHI.US&back=VLUE
CEG	CONSTELLATION ENERGY CORP	/etf/ea/ETZCW.djhtm?c=1&etfid=CEG.US&back=VLUE
HPQ	HP INC	/etf/ea/ETZCW.djhtm?c=1&etfid=HPQ.US&back=VLUE
ELV	ELEVANCE HEALTH INC	/etf/ea/ETZCW.djhtm?c=1&etfid=ELV.US&back=VLUE
GILD	GILEAD SCIENCES INC	/etf/ea/ETZCW.djhtm?c=1&etfid=GILD.US&back=VLUE
KHC	KRAFT HEINZ	/etf/ea/ETZCW.djhtm?c=1&etfid=KHC.US&back=VLUE
CBRE	CBRE GROUP INC CLASS A	/etf/ea/ETZCW.djhtm?c=1&etfid=CBRE.US&back=VLUE
DVN	DEVON ENERGY CORP	/etf/ea/ETZCW.djhtm?c=1&etfid=DVN.US&back=VLUE
WBA	WALGREEN BOOTS ALLIANCE INC	/etf/ea/ETZCW.djhtm?c=1&etfid=WBA.US&back=VLUE
PXD	PIONEER NATURAL RESOURCE	/etf/ea/ETZCW.djhtm?c=1&etfid=PXD.US&back=VLUE
KR	KROGER	/etf/ea/ETZCW.djhtm?c=1&etfid=KR.US&back=VLUE
PSA	PUBLIC STORAGE REIT	/etf/ea/ETZCW.djhtm?c=1&etfid=PSA.US&back=VLUE
GPN	GLOBAL PAYMENTS INC	/etf/ea/ETZCW.djhtm?c=1&etfid=GPN.US&back=VLUE
HPE	HEWLETT PACKARD ENTERPRISE	/etf/ea/ETZCW.djhtm?c=1&etfid=HPE.US&back=VLUE
COF	CAPITAL ONE FINANCIAL CORP	/etf/ea/ETZCW.djhtm?c=1&etfid=COF.US&back=VLUE
WY	WEYERHAEUSER REIT	/etf/ea/ETZCW.djhtm?c=1&etfid=WY.US&back=VLUE
TSN	TYSON FOODS INC CLASS A	/etf/ea/ETZCW.djhtm?c=1&etfid=TSN.US&back=VLUE
LHX	L3HARRIS TECHNOLOGIES INC	/etf/ea/ETZCW.djhtm?c=1&etfid=LHX.US&back=VLUE
TEL	TE CONNECTIVITY LTD	/etf/ea/ETZCW.djhtm?c=1&etfid=TEL.US&back=VLUE
GLW	CORNING INC	/etf/ea/ETZCW.djhtm?c=1&etfid=GLW.US&back=VLUE
NXPI	NXP SEMICONDUCTORS NV	/etf/ea/ETZCW.djhtm?c=1&etfid=NXPI.US&back=VLUE
SPG	SIMON PROPERTY GROUP REIT INC	/etf/ea/ETZCW.djhtm?c=1&etfid=SPG.US&back=VLUE
CNC	CENTENE CORP	/etf/ea/ETZCW.djhtm?c=1&etfid=CNC.US&back=VLUE
ADM	ARCHER DANIELS MIDLAND	/etf/ea/ETZCW.djhtm?c=1&etfid=ADM.US&back=VLUE
PHM	PULTEGROUP INC	/etf/ea/ETZCW.djhtm?c=1&etfid=PHM.US&back=VLUE
GD	GENERAL DYNAMICS CORP	/etf/ea/ETZCW.djhtm?c=1&etfid=GD.US&back=VLUE
AIG	AMERICAN INTERNATIONAL GROUP INC	/etf/ea/ETZCW.djhtm?c=1&etfid=AIG.US&back=VLUE
MET	METLIFE INC	/etf/ea/ETZCW.djhtm?c=1&etfid=MET.US&back=VLUE
FANG	DIAMONDBACK ENERGY INC	/etf/ea/ETZCW.djhtm?c=1&etfid=FANG.US&back=VLUE
CTSH	COGNIZANT TECHNOLOGY SOLUTIONS COR	/etf/ea/ETZCW.djhtm?c=1&etfid=CTSH.US&back=VLUE
PPL	PPL CORP	/etf/ea/ETZCW.djhtm?c=1&etfid=PPL.US&back=VLUE
NUE	NUCOR CORP	/etf/ea/ETZCW.djhtm?c=1&etfid=NUE.US&back=VLUE
PCG	PG&E CORP	/etf/ea/ETZCW.djhtm?c=1&etfid=PCG.US&back=VLUE
PCAR	PACCAR INC	/etf/ea/ETZCW.djhtm?c=1&etfid=PCAR.US&back=VLUE
ON	ON SEMICONDUCTOR CORP	/etf/ea/ETZCW.djhtm?c=1&etfid=ON.US&back=VLUE
WDC	WESTERN DIGITAL CORP	/etf/ea/ETZCW.djhtm?c=1&etfid=WDC.US&back=VLUE
CMI	CUMMINS INC	/etf/ea/ETZCW.djhtm?c=1&etfid=CMI.US&back=VLUE
BBY	BEST BUY INC	/etf/ea/ETZCW.djhtm?c=1&etfid=BBY.US&back=VLUE
ED	CONSOLIDATED EDISON INC	/etf/ea/ETZCW.djhtm?c=1&etfid=ED.US&back=VLUE
MCK	MCKESSON CORP	/etf/ea/ETZCW.djhtm?c=1&etfid=MCK.US&back=VLUE
PRU	PRUDENTIAL FINANCIAL INC	/etf/ea/ETZCW.djhtm?c=1&etfid=PRU.US&back=VLUE
JCI	JOHNSON CONTROLS INTERNATIONAL PLC	/etf/ea/ETZCW.djhtm?c=1&etfid=JCI.US&back=VLUE
MRNA	MODERNA INC	/etf/ea/ETZCW.djhtm?c=1&etfid=MRNA.US&back=VLUE
PARA	PARAMOUNT GLOBAL CLASS B	/etf/ea/ETZCW.djhtm?c=1&etfid=PARA.US&back=VLUE
LKQ	LKQ CORP	/etf/ea/ETZCW.djhtm?c=1&etfid=LKQ.US&back=VLUE
BWA	BORGWARNER INC	/etf/ea/ETZCW.djhtm?c=1&etfid=BWA.US&back=VLUE
LUMN	LUMEN TECHNOLOGIES INC	/etf/ea/ETZCW.djhtm?c=1&etfid=LUMN.US&back=VLUE
WHR	WHIRLPOOL CORP	/etf/ea/ETZCW.djhtm?c=1&etfid=WHR.US&back=VLUE
TAP	MOLSON COORS BREWINGCLASS B	/etf/ea/ETZCW.djhtm?c=1&etfid=TAP.US&back=VLUE
BK	BANK OF NEW YORK MELLON CORP	/etf/ea/ETZCW.djhtm?c=1&etfid=BK.US&back=VLUE
URI	UNITED RENTALS INC	/etf/ea/ETZCW.djhtm?c=1&etfid=URI.US&back=VLUE
SJM	JM SMUCKER	/etf/ea/ETZCW.djhtm?c=1&etfid=SJM.US&back=VLUE
LYB	LYONDELLBASELL INDUSTRIES NV CLASS	/etf/ea/ETZCW.djhtm?c=1&etfid=LYB.US&back=VLUE
DOW	DOW INC	/etf/ea/ETZCW.djhtm?c=1&etfid=DOW.US&back=VLUE
LEA	LEAR CORP	/etf/ea/ETZCW.djhtm?c=1&etfid=LEA.US&back=VLUE
CAG	CONAGRA BRANDS INC	/etf/ea/ETZCW.djhtm?c=1&etfid=CAG.US&back=VLUE
CTRA	COTERRA ENERGY INC	/etf/ea/ETZCW.djhtm?c=1&etfid=CTRA.US&back=VLUE
LBTYK	LIBERTY GLOBAL PLC CLASS C	/etf/ea/ETZCW.djhtm?c=1&etfid=LBTYK.US&back=VLUE
MOS	MOSAIC	/etf/ea/ETZCW.djhtm?c=1&etfid=MOS.US&back=VLUE
SWKS	SKYWORKS SOLUTIONS INC	/etf/ea/ETZCW.djhtm?c=1&etfid=SWKS.US&back=VLUE
MRO	MARATHON OIL CORP	/etf/ea/ETZCW.djhtm?c=1&etfid=MRO.US&back=VLUE
VMW	VMWARE CLASS A INC	/etf/ea/ETZCW.djhtm?c=1&etfid=VMW.US&back=VLUE
STX	SEAGATE TECHNOLOGY HOLDINGS PLC	/etf/ea/ETZCW.djhtm?c=1&etfid=STX.US&back=VLUE
MHK	MOHAWK INDUSTRIES INC	/etf/ea/ETZCW.djhtm?c=1&etfid=MHK.US&back=VLUE
	USD CASH	
DELL	DELL TECHNOLOGIES INC CLASS C	/etf/ea/ETZCW.djhtm?c=1&etfid=DELL.US&back=VLUE
BIIB	BIOGEN INC	/etf/ea/ETZCW.djhtm?c=1&etfid=BIIB.US&back=VLUE
ARW	ARROW ELECTRONICS INC	/etf/ea/ETZCW.djhtm?c=1&etfid=ARW.US&back=VLUE
EVRG	EVERGY INC	/etf/ea/ETZCW.djhtm?c=1&etfid=EVRG.US&back=VLUE
WAB	WESTINGHOUSE AIR BRAKE TECHNOLOGIE	/etf/ea/ETZCW.djhtm?c=1&etfid=WAB.US&back=VLUE
FOXA	FOX CORP CLASS A	/etf/ea/ETZCW.djhtm?c=1&etfid=FOXA.US&back=VLUE
CFG	CITIZENS FINANCIAL GROUP INC	/etf/ea/ETZCW.djhtm?c=1&etfid=CFG.US&back=VLUE
UGI	UGI CORP	/etf/ea/ETZCW.djhtm?c=1&etfid=UGI.US&back=VLUE
NTAP	NETAPP INC	/etf/ea/ETZCW.djhtm?c=1&etfid=NTAP.US&back=VLUE
STLD	STEEL DYNAMICS INC	/etf/ea/ETZCW.djhtm?c=1&etfid=STLD.US&back=VLUE
VTRS	VIATRIS INC	/etf/ea/ETZCW.djhtm?c=1&etfid=VTRS.US&back=VLUE
NRG	NRG ENERGY INC	/etf/ea/ETZCW.djhtm?c=1&etfid=NRG.US&back=VLUE
NWL	NEWELL BRANDS INC	/etf/ea/ETZCW.djhtm?c=1&etfid=NWL.US&back=VLUE
SSNC	SS AND C TECHNOLOGIES HOLDINGS INC	/etf/ea/ETZCW.djhtm?c=1&etfid=SSNC.US&back=VLUE
QRVO	QORVO INC	/etf/ea/ETZCW.djhtm?c=1&etfid=QRVO.US&back=VLUE
EQH	EQUITABLE HOLDINGS INC	/etf/ea/ETZCW.djhtm?c=1&etfid=EQH.US&back=VLUE
KNX	KNIGHT-SWIFT TRANSPORTATION HOLDIN	/etf/ea/ETZCW.djhtm?c=1&etfid=KNX.US&back=VLUE
OC	OWENS CORNING	/etf/ea/ETZCW.djhtm?c=1&etfid=OC.US&back=VLUE
JNPR	JUNIPER NETWORKS INC	/etf/ea/ETZCW.djhtm?c=1&etfid=JNPR.US&back=VLUE
RF	REGIONS FINANCIAL CORP	/etf/ea/ETZCW.djhtm?c=1&etfid=RF.US&back=VLUE
TXT	TEXTRON INC	/etf/ea/ETZCW.djhtm?c=1&etfid=TXT.US&back=VLUE
CAH	CARDINAL HEALTH INC	/etf/ea/ETZCW.djhtm?c=1&etfid=CAH.US&back=VLUE
STT	STATE STREET CORP	/etf/ea/ETZCW.djhtm?c=1&etfid=STT.US&back=VLUE
ALLY	ALLY FINANCIAL INC	/etf/ea/ETZCW.djhtm?c=1&etfid=ALLY.US&back=VLUE
FITB	FIFTH THIRD BANCORP	/etf/ea/ETZCW.djhtm?c=1&etfid=FITB.US&back=VLUE
PFG	PRINCIPAL FINANCIAL GROUP INC	/etf/ea/ETZCW.djhtm?c=1&etfid=PFG.US&back=VLUE
SWK	STANLEY BLACK & DECKER INC	/etf/ea/ETZCW.djhtm?c=1&etfid=SWK.US&back=VLUE
HIG	HARTFORD FINANCIAL SERVICES GROUP	/etf/ea/ETZCW.djhtm?c=1&etfid=HIG.US&back=VLUE
SNA	SNAP ON INC	/etf/ea/ETZCW.djhtm?c=1&etfid=SNA.US&back=VLUE
APA	APA CORP	/etf/ea/ETZCW.djhtm?c=1&etfid=APA.US&back=VLUE
LNC	LINCOLN NATIONAL CORP	/etf/ea/ETZCW.djhtm?c=1&etfid=LNC.US&back=VLUE
NLY	ANNALY CAPITAL MANAGEMENT REIT INC	/etf/ea/ETZCW.djhtm?c=1&etfid=NLY.US&back=VLUE
CF	CF INDUSTRIES HOLDINGS INC	/etf/ea/ETZCW.djhtm?c=1&etfid=CF.US&back=VLUE
FFIV	F5 INC	/etf/ea/ETZCW.djhtm?c=1&etfid=FFIV.US&back=VLUE
IP	INTERNATIONAL PAPER	/etf/ea/ETZCW.djhtm?c=1&etfid=IP.US&back=VLUE
L	LOEWS CORP	/etf/ea/ETZCW.djhtm?c=1&etfid=L.US&back=VLUE
LDOS	LEIDOS HOLDINGS INC	/etf/ea/ETZCW.djhtm?c=1&etfid=LDOS.US&back=VLUE
HII	HUNTINGTON INGALLS INDUSTRIES INC	/etf/ea/ETZCW.djhtm?c=1&etfid=HII.US&back=VLUE
RE	EVEREST RE GROUP LTD	/etf/ea/ETZCW.djhtm?c=1&etfid=RE.US&back=VLUE
WRK	WESTROCK	/etf/ea/ETZCW.djhtm?c=1&etfid=WRK.US&back=VLUE
LH	LABORATORY CORPORATION OF AMERICA	/etf/ea/ETZCW.djhtm?c=1&etfid=LH.US&back=VLUE
WU	WESTERN UNION	/etf/ea/ETZCW.djhtm?c=1&etfid=WU.US&back=VLUE
DGX	QUEST DIAGNOSTICS INC	/etf/ea/ETZCW.djhtm?c=1&etfid=DGX.US&back=VLUE
DISH	DISH NETWORK CORP CLASS A	/etf/ea/ETZCW.djhtm?c=1&etfid=DISH.US&back=VLUE
FOX	FOX CORP CLASS B	/etf/ea/ETZCW.djhtm?c=1&etfid=FOX.US&back=VLUE
CLF	CLEVELAND CLIFFS INC	/etf/ea/ETZCW.djhtm?c=1&etfid=CLF.US&back=VLUE
UHAL	AMERCO	/etf/ea/ETZCW.djhtm?c=1&etfid=UHAL.US&back=VLUE
JAZZ	JAZZ PHARMACEUTICALS PLC	/etf/ea/ETZCW.djhtm?c=1&etfid=JAZZ.US&back=VLUE
EMN	EASTMAN CHEMICAL	/etf/ea/ETZCW.djhtm?c=1&etfid=EMN.US&back=VLUE
LBTYA	LIBERTY GLOBAL PLC CLASS A	/etf/ea/ETZCW.djhtm?c=1&etfid=LBTYA.US&back=VLUE
IVZ	INVESCO LTD	/etf/ea/ETZCW.djhtm?c=1&etfid=IVZ.US&back=VLUE
BEN	FRANKLIN RESOURCES INC	/etf/ea/ETZCW.djhtm?c=1&etfid=BEN.US&back=VLUE
	BLK CSH FND TREASURY SL AGENCY	
Y	ALLEGHANYCORP	/etf/ea/ETZCW.djhtm?c=1&etfid=Y.US&back=VLUE
ST	SENSATA TECHNOLOGIES HOLDING PLC	/etf/ea/ETZCW.djhtm?c=1&etfid=ST.US&back=VLUE
UHS	UNIVERSAL HEALTH SERVICES INC CLAS	/etf/ea/ETZCW.djhtm?c=1&etfid=UHS.US&back=VLUE
FNF	FIDELITY NATIONAL FINANCIAL INC	/etf/ea/ETZCW.djhtm?c=1&etfid=FNF.US&back=VLUE
AA	ALCOA CORP	/etf/ea/ETZCW.djhtm?c=1&etfid=AA.US&back=VLUE
TDOC	TELADOC HEALTH INC	/etf/ea/ETZCW.djhtm?c=1&etfid=TDOC.US&back=VLUE
CLVT	CLARIVATE PLC	/etf/ea/ETZCW.djhtm?c=1&etfid=CLVT.US&back=VLUE
LUV	SOUTHWEST AIRLINES	/etf/ea/ETZCW.djhtm?c=1&etfid=LUV.US&back=VLUE
DVA	DAVITA INC	/etf/ea/ETZCW.djhtm?c=1&etfid=DVA.US&back=VLUE
WLK	WESTLAKE CORP	/etf/ea/ETZCW.djhtm?c=1&etfid=WLK.US&back=VLUE
	CASH COLLATERAL USD SGAFT	
