XHE
BFLY	Butterfly Network Inc. Class A	/etf/ea/ETZCW.djhtm?c=1&etfid=BFLY.US&back=XHE
SENS	Senseonics Holdings Inc.	/etf/ea/ETZCW.djhtm?c=1&etfid=SENS.US&back=XHE
BLFS	BioLife Solutions Inc.	/etf/ea/ETZCW.djhtm?c=1&etfid=BLFS.US&back=XHE
SWAV	Shockwave Medical Inc.	/etf/ea/ETZCW.djhtm?c=1&etfid=SWAV.US&back=XHE
FIGS	FIGS Inc. Class A	/etf/ea/ETZCW.djhtm?c=1&etfid=FIGS.US&back=XHE
STAA	STAAR Surgical Company	/etf/ea/ETZCW.djhtm?c=1&etfid=STAA.US&back=XHE
TMDX	TransMedics Group Inc.	/etf/ea/ETZCW.djhtm?c=1&etfid=TMDX.US&back=XHE
AXNX	Axonics Inc.	/etf/ea/ETZCW.djhtm?c=1&etfid=AXNX.US&back=XHE
CYRX	CryoPort Inc.	/etf/ea/ETZCW.djhtm?c=1&etfid=CYRX.US&back=XHE
PEN	Penumbra Inc.	/etf/ea/ETZCW.djhtm?c=1&etfid=PEN.US&back=XHE
LNTH	Lantheus Holdings Inc	/etf/ea/ETZCW.djhtm?c=1&etfid=LNTH.US&back=XHE
VIVO	Meridian Bioscience Inc.	/etf/ea/ETZCW.djhtm?c=1&etfid=VIVO.US&back=XHE
NVCR	NovoCure Ltd.	/etf/ea/ETZCW.djhtm?c=1&etfid=NVCR.US&back=XHE
EMBC	Embecta Corporation	/etf/ea/ETZCW.djhtm?c=1&etfid=EMBC.US&back=XHE
ATRC	AtriCure Inc.	/etf/ea/ETZCW.djhtm?c=1&etfid=ATRC.US&back=XHE
HAE	Haemonetics Corporation	/etf/ea/ETZCW.djhtm?c=1&etfid=HAE.US&back=XHE
PODD	Insulet Corporation	/etf/ea/ETZCW.djhtm?c=1&etfid=PODD.US&back=XHE
DXCM	DexCom Inc.	/etf/ea/ETZCW.djhtm?c=1&etfid=DXCM.US&back=XHE
CUTR	Cutera Inc.	/etf/ea/ETZCW.djhtm?c=1&etfid=CUTR.US&back=XHE
GKOS	Glaukos Corp	/etf/ea/ETZCW.djhtm?c=1&etfid=GKOS.US&back=XHE
IRTC	iRhythm Technologies Inc.	/etf/ea/ETZCW.djhtm?c=1&etfid=IRTC.US&back=XHE
SILK	Silk Road Medical Inc.	/etf/ea/ETZCW.djhtm?c=1&etfid=SILK.US&back=XHE
NARI	Inari Medical Inc.	/etf/ea/ETZCW.djhtm?c=1&etfid=NARI.US&back=XHE
BSX	Boston Scientific Corporation	/etf/ea/ETZCW.djhtm?c=1&etfid=BSX.US&back=XHE
MASI	Masimo Corporation	/etf/ea/ETZCW.djhtm?c=1&etfid=MASI.US&back=XHE
RMD	ResMed Inc.	/etf/ea/ETZCW.djhtm?c=1&etfid=RMD.US&back=XHE
ABMD	ABIOMED Inc.	/etf/ea/ETZCW.djhtm?c=1&etfid=ABMD.US&back=XHE
MMSI	Merit Medical Systems Inc.	/etf/ea/ETZCW.djhtm?c=1&etfid=MMSI.US&back=XHE
LMAT	LeMaitre Vascular Inc.	/etf/ea/ETZCW.djhtm?c=1&etfid=LMAT.US&back=XHE
BDX	Becton Dickinson and Company	/etf/ea/ETZCW.djhtm?c=1&etfid=BDX.US&back=XHE
IDXX	IDEXX Laboratories Inc.	/etf/ea/ETZCW.djhtm?c=1&etfid=IDXX.US&back=XHE
ISRG	Intuitive Surgical Inc.	/etf/ea/ETZCW.djhtm?c=1&etfid=ISRG.US&back=XHE
LUNG	Pulmonx Corp.	/etf/ea/ETZCW.djhtm?c=1&etfid=LUNG.US&back=XHE
GMED	Globus Medical Inc Class A	/etf/ea/ETZCW.djhtm?c=1&etfid=GMED.US&back=XHE
HSKA	Heska Corporation	/etf/ea/ETZCW.djhtm?c=1&etfid=HSKA.US&back=XHE
NVRO	Nevro Corp.	/etf/ea/ETZCW.djhtm?c=1&etfid=NVRO.US&back=XHE
EW	Edwards Lifesciences Corporation	/etf/ea/ETZCW.djhtm?c=1&etfid=EW.US&back=XHE
SYK	Stryker Corporation	/etf/ea/ETZCW.djhtm?c=1&etfid=SYK.US&back=XHE
ALGN	Align Technology Inc.	/etf/ea/ETZCW.djhtm?c=1&etfid=ALGN.US&back=XHE
MDT	Medtronic Plc	/etf/ea/ETZCW.djhtm?c=1&etfid=MDT.US&back=XHE
HOLX	Hologic Inc.	/etf/ea/ETZCW.djhtm?c=1&etfid=HOLX.US&back=XHE
ZBH	Zimmer Biomet Holdings Inc.	/etf/ea/ETZCW.djhtm?c=1&etfid=ZBH.US&back=XHE
ABT	Abbott Laboratories	/etf/ea/ETZCW.djhtm?c=1&etfid=ABT.US&back=XHE
ATEC	Alphatec Holdings Inc.	/etf/ea/ETZCW.djhtm?c=1&etfid=ATEC.US&back=XHE
NVST	Envista Holdings Corp.	/etf/ea/ETZCW.djhtm?c=1&etfid=NVST.US&back=XHE
ICUI	ICU Medical Inc.	/etf/ea/ETZCW.djhtm?c=1&etfid=ICUI.US&back=XHE
AVNS	Avanos Medical Inc.	/etf/ea/ETZCW.djhtm?c=1&etfid=AVNS.US&back=XHE
STE	STERIS Plc	/etf/ea/ETZCW.djhtm?c=1&etfid=STE.US&back=XHE
SIBN	SI-BONE Inc.	/etf/ea/ETZCW.djhtm?c=1&etfid=SIBN.US&back=XHE
VREX	Varex Imaging Corporation	/etf/ea/ETZCW.djhtm?c=1&etfid=VREX.US&back=XHE
KIDS	OrthoPediatrics Corp.	/etf/ea/ETZCW.djhtm?c=1&etfid=KIDS.US&back=XHE
OMCL	Omnicell Inc.	/etf/ea/ETZCW.djhtm?c=1&etfid=OMCL.US&back=XHE
ANGO	AngioDynamics Inc.	/etf/ea/ETZCW.djhtm?c=1&etfid=ANGO.US&back=XHE
OM	Outset Medical Inc.	/etf/ea/ETZCW.djhtm?c=1&etfid=OM.US&back=XHE
NEOG	Neogen Corporation	/etf/ea/ETZCW.djhtm?c=1&etfid=NEOG.US&back=XHE
COO	Cooper Companies Inc.	/etf/ea/ETZCW.djhtm?c=1&etfid=COO.US&back=XHE
CERS	Cerus Corporation	/etf/ea/ETZCW.djhtm?c=1&etfid=CERS.US&back=XHE
CNMD	CONMED Corporation	/etf/ea/ETZCW.djhtm?c=1&etfid=CNMD.US&back=XHE
VRAY	ViewRay Inc.	/etf/ea/ETZCW.djhtm?c=1&etfid=VRAY.US&back=XHE
XRAY	DENTSPLY SIRONA Inc.	/etf/ea/ETZCW.djhtm?c=1&etfid=XRAY.US&back=XHE
LIVN	LivaNova Plc	/etf/ea/ETZCW.djhtm?c=1&etfid=LIVN.US&back=XHE
TFX	Teleflex Incorporated	/etf/ea/ETZCW.djhtm?c=1&etfid=TFX.US&back=XHE
ITGR	Integer Holdings Corporation	/etf/ea/ETZCW.djhtm?c=1&etfid=ITGR.US&back=XHE
QDEL	QuidelOrtho Corporation	/etf/ea/ETZCW.djhtm?c=1&etfid=QDEL.US&back=XHE
AORT	Artivion Inc.	/etf/ea/ETZCW.djhtm?c=1&etfid=AORT.US&back=XHE
NUVA	NuVasive Inc.	/etf/ea/ETZCW.djhtm?c=1&etfid=NUVA.US&back=XHE
ENOV	Enovis Corporation	/etf/ea/ETZCW.djhtm?c=1&etfid=ENOV.US&back=XHE
IART	Integra LifeSciences Holdings Corporation	/etf/ea/ETZCW.djhtm?c=1&etfid=IART.US&back=XHE
BAX	Baxter International Inc.	/etf/ea/ETZCW.djhtm?c=1&etfid=BAX.US&back=XHE
TNDM	Tandem Diabetes Care Inc.	/etf/ea/ETZCW.djhtm?c=1&etfid=TNDM.US&back=XHE
ZIMV	ZimVie Inc.	/etf/ea/ETZCW.djhtm?c=1&etfid=ZIMV.US&back=XHE
MLAB	Mesa Laboratories Inc.	/etf/ea/ETZCW.djhtm?c=1&etfid=MLAB.US&back=XHE
CSII	Cardiovascular Systems Inc.	/etf/ea/ETZCW.djhtm?c=1&etfid=CSII.US&back=XHE
INGN	Inogen Inc.	/etf/ea/ETZCW.djhtm?c=1&etfid=INGN.US&back=XHE
OSUR	OraSure Technologies Inc.	/etf/ea/ETZCW.djhtm?c=1&etfid=OSUR.US&back=XHE
AXGN	Axogen Inc.	/etf/ea/ETZCW.djhtm?c=1&etfid=AXGN.US&back=XHE
ATRI	Atrion Corporation	/etf/ea/ETZCW.djhtm?c=1&etfid=ATRI.US&back=XHE
OFIX	Orthofix Medical Inc.	/etf/ea/ETZCW.djhtm?c=1&etfid=OFIX.US&back=XHE
UFPT	UFP Technologies Inc.	/etf/ea/ETZCW.djhtm?c=1&etfid=UFPT.US&back=XHE
SRDX	SurModics Inc.	/etf/ea/ETZCW.djhtm?c=1&etfid=SRDX.US&back=XHE
	STATE STREET INSTITUTIONAL LIQ STATE STR	
