XLI
UPS	United Parcel Service Inc. Class B	/etf/ea/ETZCW.djhtm?c=1&etfid=UPS.US&back=XLI
UNP	Union Pacific Corporation	/etf/ea/ETZCW.djhtm?c=1&etfid=UNP.US&back=XLI
RTX	Raytheon Technologies Corporation	/etf/ea/ETZCW.djhtm?c=1&etfid=RTX.US&back=XLI
HON	Honeywell International Inc.	/etf/ea/ETZCW.djhtm?c=1&etfid=HON.US&back=XLI
DE	Deere & Company	/etf/ea/ETZCW.djhtm?c=1&etfid=DE.US&back=XLI
LMT	Lockheed Martin Corporation	/etf/ea/ETZCW.djhtm?c=1&etfid=LMT.US&back=XLI
CAT	Caterpillar Inc.	/etf/ea/ETZCW.djhtm?c=1&etfid=CAT.US&back=XLI
BA	Boeing Company	/etf/ea/ETZCW.djhtm?c=1&etfid=BA.US&back=XLI
GE	General Electric Company	/etf/ea/ETZCW.djhtm?c=1&etfid=GE.US&back=XLI
MMM	3M Company	/etf/ea/ETZCW.djhtm?c=1&etfid=MMM.US&back=XLI
NOC	Northrop Grumman Corp.	/etf/ea/ETZCW.djhtm?c=1&etfid=NOC.US&back=XLI
CSX	CSX Corporation	/etf/ea/ETZCW.djhtm?c=1&etfid=CSX.US&back=XLI
WM	Waste Management Inc.	/etf/ea/ETZCW.djhtm?c=1&etfid=WM.US&back=XLI
NSC	Norfolk Southern Corporation	/etf/ea/ETZCW.djhtm?c=1&etfid=NSC.US&back=XLI
ITW	Illinois Tool Works Inc.	/etf/ea/ETZCW.djhtm?c=1&etfid=ITW.US&back=XLI
ETN	Eaton Corp. Plc	/etf/ea/ETZCW.djhtm?c=1&etfid=ETN.US&back=XLI
GD	General Dynamics Corporation	/etf/ea/ETZCW.djhtm?c=1&etfid=GD.US&back=XLI
FDX	FedEx Corporation	/etf/ea/ETZCW.djhtm?c=1&etfid=FDX.US&back=XLI
EMR	Emerson Electric Co.	/etf/ea/ETZCW.djhtm?c=1&etfid=EMR.US&back=XLI
LHX	L3Harris Technologies Inc	/etf/ea/ETZCW.djhtm?c=1&etfid=LHX.US&back=XLI
JCI	Johnson Controls International plc	/etf/ea/ETZCW.djhtm?c=1&etfid=JCI.US&back=XLI
TT	Trane Technologies plc	/etf/ea/ETZCW.djhtm?c=1&etfid=TT.US&back=XLI
CTAS	Cintas Corporation	/etf/ea/ETZCW.djhtm?c=1&etfid=CTAS.US&back=XLI
PH	Parker-Hannifin Corporation	/etf/ea/ETZCW.djhtm?c=1&etfid=PH.US&back=XLI
CARR	Carrier Global Corp.	/etf/ea/ETZCW.djhtm?c=1&etfid=CARR.US&back=XLI
TDG	TransDigm Group Incorporated	/etf/ea/ETZCW.djhtm?c=1&etfid=TDG.US&back=XLI
OTIS	Otis Worldwide Corporation	/etf/ea/ETZCW.djhtm?c=1&etfid=OTIS.US&back=XLI
PCAR	PACCAR Inc	/etf/ea/ETZCW.djhtm?c=1&etfid=PCAR.US&back=XLI
CMI	Cummins Inc.	/etf/ea/ETZCW.djhtm?c=1&etfid=CMI.US&back=XLI
RSG	Republic Services Inc.	/etf/ea/ETZCW.djhtm?c=1&etfid=RSG.US&back=XLI
VRSK	Verisk Analytics Inc	/etf/ea/ETZCW.djhtm?c=1&etfid=VRSK.US&back=XLI
FAST	Fastenal Company	/etf/ea/ETZCW.djhtm?c=1&etfid=FAST.US&back=XLI
AME	AMETEK Inc.	/etf/ea/ETZCW.djhtm?c=1&etfid=AME.US&back=XLI
ROK	Rockwell Automation Inc.	/etf/ea/ETZCW.djhtm?c=1&etfid=ROK.US&back=XLI
CPRT	Copart Inc.	/etf/ea/ETZCW.djhtm?c=1&etfid=CPRT.US&back=XLI
ODFL	Old Dominion Freight Line Inc.	/etf/ea/ETZCW.djhtm?c=1&etfid=ODFL.US&back=XLI
GWW	W.W. Grainger Inc.	/etf/ea/ETZCW.djhtm?c=1&etfid=GWW.US&back=XLI
EFX	Equifax Inc.	/etf/ea/ETZCW.djhtm?c=1&etfid=EFX.US&back=XLI
FTV	Fortive Corp.	/etf/ea/ETZCW.djhtm?c=1&etfid=FTV.US&back=XLI
LUV	Southwest Airlines Co.	/etf/ea/ETZCW.djhtm?c=1&etfid=LUV.US&back=XLI
URI	United Rentals Inc.	/etf/ea/ETZCW.djhtm?c=1&etfid=URI.US&back=XLI
PWR	Quanta Services Inc.	/etf/ea/ETZCW.djhtm?c=1&etfid=PWR.US&back=XLI
DAL	Delta Air Lines Inc.	/etf/ea/ETZCW.djhtm?c=1&etfid=DAL.US&back=XLI
IR	Ingersoll Rand Inc.	/etf/ea/ETZCW.djhtm?c=1&etfid=IR.US&back=XLI
DOV	Dover Corporation	/etf/ea/ETZCW.djhtm?c=1&etfid=DOV.US&back=XLI
EXPD	Expeditors International of Washington Inc.	/etf/ea/ETZCW.djhtm?c=1&etfid=EXPD.US&back=XLI
XYL	Xylem Inc.	/etf/ea/ETZCW.djhtm?c=1&etfid=XYL.US&back=XLI
J	Jacobs Solutions Inc.	/etf/ea/ETZCW.djhtm?c=1&etfid=J.US&back=XLI
WAB	Westinghouse Air Brake Technologies Corporation	/etf/ea/ETZCW.djhtm?c=1&etfid=WAB.US&back=XLI
IEX	IDEX Corporation	/etf/ea/ETZCW.djhtm?c=1&etfid=IEX.US&back=XLI
JBHT	J.B. Hunt Transport Services Inc.	/etf/ea/ETZCW.djhtm?c=1&etfid=JBHT.US&back=XLI
CHRW	C.H. Robinson Worldwide Inc.	/etf/ea/ETZCW.djhtm?c=1&etfid=CHRW.US&back=XLI
GNRC	Generac Holdings Inc.	/etf/ea/ETZCW.djhtm?c=1&etfid=GNRC.US&back=XLI
TXT	Textron Inc.	/etf/ea/ETZCW.djhtm?c=1&etfid=TXT.US&back=XLI
HWM	Howmet Aerospace Inc.	/etf/ea/ETZCW.djhtm?c=1&etfid=HWM.US&back=XLI
SWK	Stanley Black & Decker Inc.	/etf/ea/ETZCW.djhtm?c=1&etfid=SWK.US&back=XLI
LDOS	Leidos Holdings Inc.	/etf/ea/ETZCW.djhtm?c=1&etfid=LDOS.US&back=XLI
NDSN	Nordson Corporation	/etf/ea/ETZCW.djhtm?c=1&etfid=NDSN.US&back=XLI
MAS	Masco Corporation	/etf/ea/ETZCW.djhtm?c=1&etfid=MAS.US&back=XLI
SNA	Snap-on Incorporated	/etf/ea/ETZCW.djhtm?c=1&etfid=SNA.US&back=XLI
UAL	United Airlines Holdings Inc.	/etf/ea/ETZCW.djhtm?c=1&etfid=UAL.US&back=XLI
NLSN	Nielsen Holdings Plc	/etf/ea/ETZCW.djhtm?c=1&etfid=NLSN.US&back=XLI
HII	Huntington Ingalls Industries Inc.	/etf/ea/ETZCW.djhtm?c=1&etfid=HII.US&back=XLI
RHI	Robert Half International Inc.	/etf/ea/ETZCW.djhtm?c=1&etfid=RHI.US&back=XLI
AAL	American Airlines Group Inc.	/etf/ea/ETZCW.djhtm?c=1&etfid=AAL.US&back=XLI
ALLE	Allegion Public Limited Company	/etf/ea/ETZCW.djhtm?c=1&etfid=ALLE.US&back=XLI
FBHS	Fortune Brands Home & Security Inc.	/etf/ea/ETZCW.djhtm?c=1&etfid=FBHS.US&back=XLI
ROL	Rollins Inc.	/etf/ea/ETZCW.djhtm?c=1&etfid=ROL.US&back=XLI
PNR	Pentair plc	/etf/ea/ETZCW.djhtm?c=1&etfid=PNR.US&back=XLI
AOS	A. O. Smith Corporation	/etf/ea/ETZCW.djhtm?c=1&etfid=AOS.US&back=XLI
ALK	Alaska Air Group Inc.	/etf/ea/ETZCW.djhtm?c=1&etfid=ALK.US&back=XLI
	STATE STREET INSTITUTIONAL LIQ STATE STR	
	U.S. Dollar	
SPGI	S&P Global Inc.	/etf/ea/ETZCW.djhtm?c=1&etfid=SPGI.US&back=XLI
