XRT
CVNA	Carvana Co. Class A	/etf/ea/ETZCW.djhtm?c=1&etfid=CVNA.US&back=XRT
ETSY	Etsy Inc.	/etf/ea/ETZCW.djhtm?c=1&etfid=ETSY.US&back=XRT
DKS	Dick's Sporting Goods Inc.	/etf/ea/ETZCW.djhtm?c=1&etfid=DKS.US&back=XRT
SAH	Sonic Automotive Inc. Class A	/etf/ea/ETZCW.djhtm?c=1&etfid=SAH.US&back=XRT
EYE	National Vision Holdings Inc.	/etf/ea/ETZCW.djhtm?c=1&etfid=EYE.US&back=XRT
FL	Foot Locker Inc.	/etf/ea/ETZCW.djhtm?c=1&etfid=FL.US&back=XRT
MUSA	Murphy USA Inc.	/etf/ea/ETZCW.djhtm?c=1&etfid=MUSA.US&back=XRT
BJ	BJ's Wholesale Club Holdings Inc.	/etf/ea/ETZCW.djhtm?c=1&etfid=BJ.US&back=XRT
HIBB	Hibbett Inc	/etf/ea/ETZCW.djhtm?c=1&etfid=HIBB.US&back=XRT
CHWY	Chewy Inc. Class A	/etf/ea/ETZCW.djhtm?c=1&etfid=CHWY.US&back=XRT
ASO	Academy Sports and Outdoors Inc.	/etf/ea/ETZCW.djhtm?c=1&etfid=ASO.US&back=XRT
RAD	Rite Aid Corporation	/etf/ea/ETZCW.djhtm?c=1&etfid=RAD.US&back=XRT
AMZN	Amazon.com Inc.	/etf/ea/ETZCW.djhtm?c=1&etfid=AMZN.US&back=XRT
SFM	Sprouts Farmers Market Inc.	/etf/ea/ETZCW.djhtm?c=1&etfid=SFM.US&back=XRT
ORLY	O'Reilly Automotive Inc.	/etf/ea/ETZCW.djhtm?c=1&etfid=ORLY.US&back=XRT
DBI	Designer Brands Inc. Class A	/etf/ea/ETZCW.djhtm?c=1&etfid=DBI.US&back=XRT
COST	Costco Wholesale Corporation	/etf/ea/ETZCW.djhtm?c=1&etfid=COST.US&back=XRT
CWH	Camping World Holdings Inc. Class A	/etf/ea/ETZCW.djhtm?c=1&etfid=CWH.US&back=XRT
CASY	Casey's General Stores Inc.	/etf/ea/ETZCW.djhtm?c=1&etfid=CASY.US&back=XRT
ROST	Ross Stores Inc.	/etf/ea/ETZCW.djhtm?c=1&etfid=ROST.US&back=XRT
BBWI	Bath & Body Works Inc.	/etf/ea/ETZCW.djhtm?c=1&etfid=BBWI.US&back=XRT
WMT	Walmart Inc.	/etf/ea/ETZCW.djhtm?c=1&etfid=WMT.US&back=XRT
SBH	Sally Beauty Holdings Inc.	/etf/ea/ETZCW.djhtm?c=1&etfid=SBH.US&back=XRT
EVGO	EVgo Inc. Class A	/etf/ea/ETZCW.djhtm?c=1&etfid=EVGO.US&back=XRT
MNRO	Monro Inc	/etf/ea/ETZCW.djhtm?c=1&etfid=MNRO.US&back=XRT
TGT	Target Corporation	/etf/ea/ETZCW.djhtm?c=1&etfid=TGT.US&back=XRT
SIG	Signet Jewelers Limited	/etf/ea/ETZCW.djhtm?c=1&etfid=SIG.US&back=XRT
TJX	TJX Companies Inc	/etf/ea/ETZCW.djhtm?c=1&etfid=TJX.US&back=XRT
BKE	Buckle Inc.	/etf/ea/ETZCW.djhtm?c=1&etfid=BKE.US&back=XRT
GO	Grocery Outlet Holding Corp.	/etf/ea/ETZCW.djhtm?c=1&etfid=GO.US&back=XRT
AN	AutoNation Inc.	/etf/ea/ETZCW.djhtm?c=1&etfid=AN.US&back=XRT
OLLI	Ollie's Bargain Outlet Holdings Inc	/etf/ea/ETZCW.djhtm?c=1&etfid=OLLI.US&back=XRT
GCO	Genesco Inc.	/etf/ea/ETZCW.djhtm?c=1&etfid=GCO.US&back=XRT
ULTA	Ulta Beauty Inc.	/etf/ea/ETZCW.djhtm?c=1&etfid=ULTA.US&back=XRT
CHS	Chico's FAS Inc.	/etf/ea/ETZCW.djhtm?c=1&etfid=CHS.US&back=XRT
AZO	AutoZone Inc.	/etf/ea/ETZCW.djhtm?c=1&etfid=AZO.US&back=XRT
W	Wayfair Inc. Class A	/etf/ea/ETZCW.djhtm?c=1&etfid=W.US&back=XRT
PAG	Penske Automotive Group Inc.	/etf/ea/ETZCW.djhtm?c=1&etfid=PAG.US&back=XRT
DG	Dollar General Corporation	/etf/ea/ETZCW.djhtm?c=1&etfid=DG.US&back=XRT
RCII	Rent-A-Center Inc	/etf/ea/ETZCW.djhtm?c=1&etfid=RCII.US&back=XRT
FIVE	Five Below Inc.	/etf/ea/ETZCW.djhtm?c=1&etfid=FIVE.US&back=XRT
POSH	Poshmark Inc. Class A	/etf/ea/ETZCW.djhtm?c=1&etfid=POSH.US&back=XRT
EBAY	eBay Inc.	/etf/ea/ETZCW.djhtm?c=1&etfid=EBAY.US&back=XRT
GPI	Group 1 Automotive Inc.	/etf/ea/ETZCW.djhtm?c=1&etfid=GPI.US&back=XRT
IMKTA	Ingles Markets Incorporated Class A	/etf/ea/ETZCW.djhtm?c=1&etfid=IMKTA.US&back=XRT
SSTK	Shutterstock Inc.	/etf/ea/ETZCW.djhtm?c=1&etfid=SSTK.US&back=XRT
DDS	Dillard's Inc. Class A	/etf/ea/ETZCW.djhtm?c=1&etfid=DDS.US&back=XRT
BBY	Best Buy Co. Inc.	/etf/ea/ETZCW.djhtm?c=1&etfid=BBY.US&back=XRT
GPS	Gap Inc.	/etf/ea/ETZCW.djhtm?c=1&etfid=GPS.US&back=XRT
DASH	DoorDash Inc. Class A	/etf/ea/ETZCW.djhtm?c=1&etfid=DASH.US&back=XRT
ABG	Asbury Automotive Group Inc.	/etf/ea/ETZCW.djhtm?c=1&etfid=ABG.US&back=XRT
PLCE	Children's Place Inc.	/etf/ea/ETZCW.djhtm?c=1&etfid=PLCE.US&back=XRT
WOOF	Petco Health & Wellness Company Inc. Class A	/etf/ea/ETZCW.djhtm?c=1&etfid=WOOF.US&back=XRT
URBN	Urban Outfitters Inc.	/etf/ea/ETZCW.djhtm?c=1&etfid=URBN.US&back=XRT
TSCO	Tractor Supply Company	/etf/ea/ETZCW.djhtm?c=1&etfid=TSCO.US&back=XRT
AEO	American Eagle Outfitters Inc.	/etf/ea/ETZCW.djhtm?c=1&etfid=AEO.US&back=XRT
AAP	Advance Auto Parts Inc.	/etf/ea/ETZCW.djhtm?c=1&etfid=AAP.US&back=XRT
VSCO	Victoria's Secret & Company	/etf/ea/ETZCW.djhtm?c=1&etfid=VSCO.US&back=XRT
KR	Kroger Co.	/etf/ea/ETZCW.djhtm?c=1&etfid=KR.US&back=XRT
ODP	ODP Corporation	/etf/ea/ETZCW.djhtm?c=1&etfid=ODP.US&back=XRT
CAL	Caleres Inc.	/etf/ea/ETZCW.djhtm?c=1&etfid=CAL.US&back=XRT
KMX	CarMax Inc.	/etf/ea/ETZCW.djhtm?c=1&etfid=KMX.US&back=XRT
ACI	Albertsons Companies Inc. Class A	/etf/ea/ETZCW.djhtm?c=1&etfid=ACI.US&back=XRT
HZO	MarineMax Inc.	/etf/ea/ETZCW.djhtm?c=1&etfid=HZO.US&back=XRT
GES	Guess? Inc.	/etf/ea/ETZCW.djhtm?c=1&etfid=GES.US&back=XRT
LAD	Lithia Motors Inc.	/etf/ea/ETZCW.djhtm?c=1&etfid=LAD.US&back=XRT
QRTEA	Qurate Retail Inc. Class A	/etf/ea/ETZCW.djhtm?c=1&etfid=QRTEA.US&back=XRT
GME	GameStop Corp. Class A	/etf/ea/ETZCW.djhtm?c=1&etfid=GME.US&back=XRT
SCVL	Shoe Carnival Inc.	/etf/ea/ETZCW.djhtm?c=1&etfid=SCVL.US&back=XRT
DLTR	Dollar Tree Inc.	/etf/ea/ETZCW.djhtm?c=1&etfid=DLTR.US&back=XRT
BIG	Big Lots Inc.	/etf/ea/ETZCW.djhtm?c=1&etfid=BIG.US&back=XRT
VLTA	Volta Inc. Class A	/etf/ea/ETZCW.djhtm?c=1&etfid=VLTA.US&back=XRT
OSTK	Overstock.com Inc.	/etf/ea/ETZCW.djhtm?c=1&etfid=OSTK.US&back=XRT
WBA	Walgreens Boots Alliance Inc.	/etf/ea/ETZCW.djhtm?c=1&etfid=WBA.US&back=XRT
BURL	Burlington Stores Inc.	/etf/ea/ETZCW.djhtm?c=1&etfid=BURL.US&back=XRT
BOOT	Boot Barn Holdings Inc.	/etf/ea/ETZCW.djhtm?c=1&etfid=BOOT.US&back=XRT
LESL	Leslie's Inc.	/etf/ea/ETZCW.djhtm?c=1&etfid=LESL.US&back=XRT
FRG	Franchise Group Inc. Class A	/etf/ea/ETZCW.djhtm?c=1&etfid=FRG.US&back=XRT
ZUMZ	Zumiez Inc.	/etf/ea/ETZCW.djhtm?c=1&etfid=ZUMZ.US&back=XRT
PETS	PetMed Express Inc.	/etf/ea/ETZCW.djhtm?c=1&etfid=PETS.US&back=XRT
SFIX	Stitch Fix Inc. Class A	/etf/ea/ETZCW.djhtm?c=1&etfid=SFIX.US&back=XRT
RVLV	Revolve Group Inc Class A	/etf/ea/ETZCW.djhtm?c=1&etfid=RVLV.US&back=XRT
ANF	Abercrombie & Fitch Co. Class A	/etf/ea/ETZCW.djhtm?c=1&etfid=ANF.US&back=XRT
PSMT	PriceSmart Inc.	/etf/ea/ETZCW.djhtm?c=1&etfid=PSMT.US&back=XRT
M	Macy's Inc	/etf/ea/ETZCW.djhtm?c=1&etfid=M.US&back=XRT
WISH	ContextLogic Inc. Class A	/etf/ea/ETZCW.djhtm?c=1&etfid=WISH.US&back=XRT
TA	TravelCenters of America Inc.	/etf/ea/ETZCW.djhtm?c=1&etfid=TA.US&back=XRT
PRCH	Porch Group Inc.	/etf/ea/ETZCW.djhtm?c=1&etfid=PRCH.US&back=XRT
GRPN	Groupon Inc.	/etf/ea/ETZCW.djhtm?c=1&etfid=GRPN.US&back=XRT
JWN	Nordstrom Inc.	/etf/ea/ETZCW.djhtm?c=1&etfid=JWN.US&back=XRT
KSS	Kohl's Corporation	/etf/ea/ETZCW.djhtm?c=1&etfid=KSS.US&back=XRT
SPWH	Sportsman's Warehouse Holdings Inc.	/etf/ea/ETZCW.djhtm?c=1&etfid=SPWH.US&back=XRT
WMK	Weis Markets Inc.	/etf/ea/ETZCW.djhtm?c=1&etfid=WMK.US&back=XRT
PRTS	CarParts.com Inc	/etf/ea/ETZCW.djhtm?c=1&etfid=PRTS.US&back=XRT
ONEW	OneWater Marine Inc Class A	/etf/ea/ETZCW.djhtm?c=1&etfid=ONEW.US&back=XRT
CRMT	America's Car-Mart Inc.	/etf/ea/ETZCW.djhtm?c=1&etfid=CRMT.US&back=XRT
ARKO	ARKO Corp	/etf/ea/ETZCW.djhtm?c=1&etfid=ARKO.US&back=XRT
LQDT	Liquidity Services Inc.	/etf/ea/ETZCW.djhtm?c=1&etfid=LQDT.US&back=XRT
QUOT	Quotient Technology Incorporated	/etf/ea/ETZCW.djhtm?c=1&etfid=QUOT.US&back=XRT
WINA	Winmark Corporation	/etf/ea/ETZCW.djhtm?c=1&etfid=WINA.US&back=XRT
	STATE STREET INSTITUTIONAL LIQ STATE STR	
	U.S. Dollar	
