XSLV
JBSS	John B Sanfilippo & Son Inc	/etf/ea/ETZCW.djhtm?c=1&etfid=JBSS.US&back=XSLV
CHCO	City Holding Co	/etf/ea/ETZCW.djhtm?c=1&etfid=CHCO.US&back=XSLV
NWBI	Northwest Bancshares Inc	/etf/ea/ETZCW.djhtm?c=1&etfid=NWBI.US&back=XSLV
DEA	Easterly Government Properties Inc	/etf/ea/ETZCW.djhtm?c=1&etfid=DEA.US&back=XSLV
TRST	TrustCo Bank Corp NY	/etf/ea/ETZCW.djhtm?c=1&etfid=TRST.US&back=XSLV
SAFT	Safety Insurance Group Inc	/etf/ea/ETZCW.djhtm?c=1&etfid=SAFT.US&back=XSLV
CVBF	CVB Financial Corp	/etf/ea/ETZCW.djhtm?c=1&etfid=CVBF.US&back=XSLV
CSGS	CSG Systems International Inc	/etf/ea/ETZCW.djhtm?c=1&etfid=CSGS.US&back=XSLV
ADC	Agree Realty Corp	/etf/ea/ETZCW.djhtm?c=1&etfid=ADC.US&back=XSLV
GTY	Getty Realty Corp	/etf/ea/ETZCW.djhtm?c=1&etfid=GTY.US&back=XSLV
NFBK	Northfield Bancorp Inc	/etf/ea/ETZCW.djhtm?c=1&etfid=NFBK.US&back=XSLV
WABC	Westamerica BanCorp	/etf/ea/ETZCW.djhtm?c=1&etfid=WABC.US&back=XSLV
CFFN	Capitol Federal Financial Inc	/etf/ea/ETZCW.djhtm?c=1&etfid=CFFN.US&back=XSLV
NBTB	NBT Bancorp Inc	/etf/ea/ETZCW.djhtm?c=1&etfid=NBTB.US&back=XSLV
TWNK	Hostess Brands Inc	/etf/ea/ETZCW.djhtm?c=1&etfid=TWNK.US&back=XSLV
BCPC	Balchem Corp	/etf/ea/ETZCW.djhtm?c=1&etfid=BCPC.US&back=XSLV
AVA	Avista Corp	/etf/ea/ETZCW.djhtm?c=1&etfid=AVA.US&back=XSLV
HTLD	Heartland Express Inc	/etf/ea/ETZCW.djhtm?c=1&etfid=HTLD.US&back=XSLV
WRE	Washington Real Estate Investment Trust	/etf/ea/ETZCW.djhtm?c=1&etfid=WRE.US&back=XSLV
CBU	Community Bank System Inc	/etf/ea/ETZCW.djhtm?c=1&etfid=CBU.US&back=XSLV
AWR	American States Water Co	/etf/ea/ETZCW.djhtm?c=1&etfid=AWR.US&back=XSLV
PKE	Park Aerospace Corp	/etf/ea/ETZCW.djhtm?c=1&etfid=PKE.US&back=XSLV
EIG	Employers Holdings Inc	/etf/ea/ETZCW.djhtm?c=1&etfid=EIG.US&back=XSLV
HFWA	Heritage Financial Corp/WA	/etf/ea/ETZCW.djhtm?c=1&etfid=HFWA.US&back=XSLV
NSIT	Insight Enterprises Inc	/etf/ea/ETZCW.djhtm?c=1&etfid=NSIT.US&back=XSLV
TMP	Tompkins Financial Corp	/etf/ea/ETZCW.djhtm?c=1&etfid=TMP.US&back=XSLV
LKFN	Lakeland Financial Corp	/etf/ea/ETZCW.djhtm?c=1&etfid=LKFN.US&back=XSLV
SBSI	Southside Bancshares Inc	/etf/ea/ETZCW.djhtm?c=1&etfid=SBSI.US&back=XSLV
HMN	Horace Mann Educators Corp	/etf/ea/ETZCW.djhtm?c=1&etfid=HMN.US&back=XSLV
CALM	Cal-Maine Foods Inc	/etf/ea/ETZCW.djhtm?c=1&etfid=CALM.US&back=XSLV
FCPT	Four Corners Property Trust Inc	/etf/ea/ETZCW.djhtm?c=1&etfid=FCPT.US&back=XSLV
STBA	S&T Bancorp Inc	/etf/ea/ETZCW.djhtm?c=1&etfid=STBA.US&back=XSLV
PFS	Provident Financial Services Inc	/etf/ea/ETZCW.djhtm?c=1&etfid=PFS.US&back=XSLV
CPK	Chesapeake Utilities Corp	/etf/ea/ETZCW.djhtm?c=1&etfid=CPK.US&back=XSLV
CWT	California Water Service Group	/etf/ea/ETZCW.djhtm?c=1&etfid=CWT.US&back=XSLV
JJSF	J & J Snack Foods Corp	/etf/ea/ETZCW.djhtm?c=1&etfid=JJSF.US&back=XSLV
KREF	KKR Real Estate Finance Trust Inc	/etf/ea/ETZCW.djhtm?c=1&etfid=KREF.US&back=XSLV
UVV	Universal Corp/VA	/etf/ea/ETZCW.djhtm?c=1&etfid=UVV.US&back=XSLV
NPK	National Presto Industries Inc	/etf/ea/ETZCW.djhtm?c=1&etfid=NPK.US&back=XSLV
TR	Tootsie Roll Industries Inc	/etf/ea/ETZCW.djhtm?c=1&etfid=TR.US&back=XSLV
NWN	Northwest Natural Holding Co	/etf/ea/ETZCW.djhtm?c=1&etfid=NWN.US&back=XSLV
PRAA	PRA Group Inc	/etf/ea/ETZCW.djhtm?c=1&etfid=PRAA.US&back=XSLV
PRK	Park National Corp	/etf/ea/ETZCW.djhtm?c=1&etfid=PRK.US&back=XSLV
BRC	Brady Corp	/etf/ea/ETZCW.djhtm?c=1&etfid=BRC.US&back=XSLV
BRKL	Brookline Bancorp Inc	/etf/ea/ETZCW.djhtm?c=1&etfid=BRKL.US&back=XSLV
UBA	Urstadt Biddle Properties Inc	/etf/ea/ETZCW.djhtm?c=1&etfid=UBA.US&back=XSLV
EGBN	Eagle Bancorp Inc	/etf/ea/ETZCW.djhtm?c=1&etfid=EGBN.US&back=XSLV
SCL	Stepan Co	/etf/ea/ETZCW.djhtm?c=1&etfid=SCL.US&back=XSLV
OSIS	OSI Systems Inc	/etf/ea/ETZCW.djhtm?c=1&etfid=OSIS.US&back=XSLV
LTC	LTC Properties Inc	/etf/ea/ETZCW.djhtm?c=1&etfid=LTC.US&back=XSLV
TRMK	Trustmark Corp	/etf/ea/ETZCW.djhtm?c=1&etfid=TRMK.US&back=XSLV
PFBC	Preferred Bank/Los Angeles CA	/etf/ea/ETZCW.djhtm?c=1&etfid=PFBC.US&back=XSLV
UNF	UniFirst Corp/MA	/etf/ea/ETZCW.djhtm?c=1&etfid=UNF.US&back=XSLV
ALG	Alamo Group Inc	/etf/ea/ETZCW.djhtm?c=1&etfid=ALG.US&back=XSLV
FBNC	First Bancorp/Southern Pines NC	/etf/ea/ETZCW.djhtm?c=1&etfid=FBNC.US&back=XSLV
UHT	Universal Health Realty Income Trust	/etf/ea/ETZCW.djhtm?c=1&etfid=UHT.US&back=XSLV
SFBS	ServisFirst Bancshares Inc	/etf/ea/ETZCW.djhtm?c=1&etfid=SFBS.US&back=XSLV
SXI	Standex International Corp	/etf/ea/ETZCW.djhtm?c=1&etfid=SXI.US&back=XSLV
FCF	First Commonwealth Financial Corp	/etf/ea/ETZCW.djhtm?c=1&etfid=FCF.US&back=XSLV
CHCT	Community Healthcare Trust Inc	/etf/ea/ETZCW.djhtm?c=1&etfid=CHCT.US&back=XSLV
AZZ	AZZ Inc	/etf/ea/ETZCW.djhtm?c=1&etfid=AZZ.US&back=XSLV
FFBC	First Financial Bancorp	/etf/ea/ETZCW.djhtm?c=1&etfid=FFBC.US&back=XSLV
BANR	Banner Corp	/etf/ea/ETZCW.djhtm?c=1&etfid=BANR.US&back=XSLV
RNST	Renasant Corp	/etf/ea/ETZCW.djhtm?c=1&etfid=RNST.US&back=XSLV
AMSF	AMERISAFE Inc	/etf/ea/ETZCW.djhtm?c=1&etfid=AMSF.US&back=XSLV
UCBI	United Community Banks Inc/GA	/etf/ea/ETZCW.djhtm?c=1&etfid=UCBI.US&back=XSLV
KN	Knowles Corp	/etf/ea/ETZCW.djhtm?c=1&etfid=KN.US&back=XSLV
CPF	Central Pacific Financial Corp	/etf/ea/ETZCW.djhtm?c=1&etfid=CPF.US&back=XSLV
AAT	American Assets Trust Inc	/etf/ea/ETZCW.djhtm?c=1&etfid=AAT.US&back=XSLV
EVTC	EVERTEC Inc	/etf/ea/ETZCW.djhtm?c=1&etfid=EVTC.US&back=XSLV
FUL	HB Fuller Co	/etf/ea/ETZCW.djhtm?c=1&etfid=FUL.US&back=XSLV
FSS	Federal Signal Corp	/etf/ea/ETZCW.djhtm?c=1&etfid=FSS.US&back=XSLV
IOSP	Innospec Inc	/etf/ea/ETZCW.djhtm?c=1&etfid=IOSP.US&back=XSLV
SFNC	Simmons First National Corp	/etf/ea/ETZCW.djhtm?c=1&etfid=SFNC.US&back=XSLV
NBHC	National Bank Holdings Corp	/etf/ea/ETZCW.djhtm?c=1&etfid=NBHC.US&back=XSLV
TNC	Tennant Co	/etf/ea/ETZCW.djhtm?c=1&etfid=TNC.US&back=XSLV
PBH	Prestige Consumer Healthcare Inc	/etf/ea/ETZCW.djhtm?c=1&etfid=PBH.US&back=XSLV
INDB	Independent Bank Corp	/etf/ea/ETZCW.djhtm?c=1&etfid=INDB.US&back=XSLV
BHLB	Berkshire Hills Bancorp Inc	/etf/ea/ETZCW.djhtm?c=1&etfid=BHLB.US&back=XSLV
CPSI	Computer Programs and Systems Inc	/etf/ea/ETZCW.djhtm?c=1&etfid=CPSI.US&back=XSLV
FBK	FB Financial Corp	/etf/ea/ETZCW.djhtm?c=1&etfid=FBK.US&back=XSLV
ROIC	Retail Opportunity Investments Corp	/etf/ea/ETZCW.djhtm?c=1&etfid=ROIC.US&back=XSLV
FHB	First Hawaiian Inc	/etf/ea/ETZCW.djhtm?c=1&etfid=FHB.US&back=XSLV
LXP	LXP Industrial Trust	/etf/ea/ETZCW.djhtm?c=1&etfid=LXP.US&back=XSLV
BANF	BancFirst Corp	/etf/ea/ETZCW.djhtm?c=1&etfid=BANF.US&back=XSLV
BHE	Benchmark Electronics Inc	/etf/ea/ETZCW.djhtm?c=1&etfid=BHE.US&back=XSLV
DCOM	Dime Community Bancshares Inc	/etf/ea/ETZCW.djhtm?c=1&etfid=DCOM.US&back=XSLV
CCOI	Cogent Communications Holdings Inc	/etf/ea/ETZCW.djhtm?c=1&etfid=CCOI.US&back=XSLV
SMP	Standard Motor Products Inc	/etf/ea/ETZCW.djhtm?c=1&etfid=SMP.US&back=XSLV
ESE	ESCO Technologies Inc	/etf/ea/ETZCW.djhtm?c=1&etfid=ESE.US&back=XSLV
EPRT	Essential Properties Realty Trust Inc	/etf/ea/ETZCW.djhtm?c=1&etfid=EPRT.US&back=XSLV
RGR	Sturm Ruger & Co Inc	/etf/ea/ETZCW.djhtm?c=1&etfid=RGR.US&back=XSLV
MSEX	Middlesex Water Co	/etf/ea/ETZCW.djhtm?c=1&etfid=MSEX.US&back=XSLV
IBTX	Independent Bank Group Inc	/etf/ea/ETZCW.djhtm?c=1&etfid=IBTX.US&back=XSLV
VIAV	Viavi Solutions Inc	/etf/ea/ETZCW.djhtm?c=1&etfid=VIAV.US&back=XSLV
ALEX	Alexander & Baldwin Inc	/etf/ea/ETZCW.djhtm?c=1&etfid=ALEX.US&back=XSLV
IRWD	Ironwood Pharmaceuticals Inc	/etf/ea/ETZCW.djhtm?c=1&etfid=IRWD.US&back=XSLV
ECPG	Encore Capital Group Inc	/etf/ea/ETZCW.djhtm?c=1&etfid=ECPG.US&back=XSLV
AHH	Armada Hoffler Properties Inc	/etf/ea/ETZCW.djhtm?c=1&etfid=AHH.US&back=XSLV
HOPE	Hope Bancorp Inc	/etf/ea/ETZCW.djhtm?c=1&etfid=HOPE.US&back=XSLV
FORR	Forrester Research Inc	/etf/ea/ETZCW.djhtm?c=1&etfid=FORR.US&back=XSLV
MOG.A	Moog Inc	/etf/ea/ETZCW.djhtm?c=1&etfid=MOG.A.US&back=XSLV
PRDO	Perdoceo Education Corp	/etf/ea/ETZCW.djhtm?c=1&etfid=PRDO.US&back=XSLV
CENTA	Central Garden & Pet Co	/etf/ea/ETZCW.djhtm?c=1&etfid=CENTA.US&back=XSLV
GNL	Global Net Lease Inc	/etf/ea/ETZCW.djhtm?c=1&etfid=GNL.US&back=XSLV
EFC	Ellington Financial Inc	/etf/ea/ETZCW.djhtm?c=1&etfid=EFC.US&back=XSLV
VRE	Veris Residential Inc	/etf/ea/ETZCW.djhtm?c=1&etfid=VRE.US&back=XSLV
USNA	USANA Health Sciences Inc	/etf/ea/ETZCW.djhtm?c=1&etfid=USNA.US&back=XSLV
CSR	Centerspace	/etf/ea/ETZCW.djhtm?c=1&etfid=CSR.US&back=XSLV
STC	Stewart Information Services Corp	/etf/ea/ETZCW.djhtm?c=1&etfid=STC.US&back=XSLV
BFS	Saul Centers Inc	/etf/ea/ETZCW.djhtm?c=1&etfid=BFS.US&back=XSLV
BDN	Brandywine Realty Trust	/etf/ea/ETZCW.djhtm?c=1&etfid=BDN.US&back=XSLV
MYE	Myers Industries Inc	/etf/ea/ETZCW.djhtm?c=1&etfid=MYE.US&back=XSLV
PMT	PennyMac Mortgage Investment Trust	/etf/ea/ETZCW.djhtm?c=1&etfid=PMT.US&back=XSLV
RC	Ready Capital Corp	/etf/ea/ETZCW.djhtm?c=1&etfid=RC.US&back=XSLV
OPI	Office Properties Income Trust	/etf/ea/ETZCW.djhtm?c=1&etfid=OPI.US&back=XSLV
IDCC	InterDigital Inc	/etf/ea/ETZCW.djhtm?c=1&etfid=IDCC.US&back=XSLV
TWO	Two Harbors Investment Corp	/etf/ea/ETZCW.djhtm?c=1&etfid=TWO.US&back=XSLV
GPMT	Granite Point Mortgage Trust Inc	/etf/ea/ETZCW.djhtm?c=1&etfid=GPMT.US&back=XSLV
ARR	ARMOUR Residential REIT Inc	/etf/ea/ETZCW.djhtm?c=1&etfid=ARR.US&back=XSLV
